9 9 0
#########
#.#.#...#
#.#.#.#.#
#...#.#.#
###.###.#
#.#....G#
#.#####.#
#..S....#
#########
