11 11 0
###########
#.#.....#.#
#.#.#.#.#.#
#...#.#.#.#
#.#####.#.#
#.#S......#
###.###.###
#...#.#G..#
#.###.#.###
#...#.....#
###########
