7 7 0
#######
#S#...#
#.#.###
#.....#
#####.#
#G....#
#######
