7 7 0
#######
#..G.S#
###.#.#
#...#.#
#.#.###
#.#...#
#######
