7 13 0
#######
#.....#
#.###.#
#.#...#
#.###.#
#.#..G#
###.###
#.....#
#.###.#
#S#...#
#.###.#
#...#.#
#######
