7 9 0
#######
#.#...#
#.#.#.#
#...#.#
#.#.###
#.#S..#
#.#.###
#.#G..#
#######
