13 13 0
#############
#...........#
#.#########.#
#...#.......#
###.#.#.#.###
#.#.#.#.#..G#
#.###.#.###.#
#.#..S#.#...#
#.#.#.#.###.#
#...#.#.#...#
#.#########.#
#.......#...#
#############
