9 13 0
#########
#...#...#
#.#####.#
#...#...#
###.###.#
#..S#.#.#
###.#.#.#
#..G#...#
###.###.#
#.#.....#
#.###.###
#.......#
#########
