9 7 0
#########
#S....#.#
#.###.#.#
#.#.....#
###.#.#.#
#G..#.#.#
#########
