15 13 0
###############
#.#.#........S#
#.#.###.#.#.###
#.#..G..#.#...#
#.#.#.###.#####
#...#...#.....#
###.#####.#####
#.....#.....#.#
#.#.#.#####.#.#
#.#.#.#...#.#.#
#.#.#####.#.#.#
#.#...#.......#
###############
