11 15 0
###########
#.#...#...#
#.#.#.#.#.#
#...#.#S#.#
#####.#.#.#
#.......#.#
###.###.###
#.....#...#
###.###.#.#
#...#...#.#
#.#.#######
#.#.......#
#.#.###.#.#
#.#.#...#G#
###########
