17 15 0
#################
#.#.#.....#.....#
#.#.###.#####.###
#G......#.......#
###.#.#.#.#####.#
#...#.#.#.....#.#
#.#####.#######.#
#...#.#.#.......#
#.#.#.#.#.#.#####
#.#.#.....#.....#
###.#####.###.#.#
#...#.....#...#.#
#.###.###.###.###
#S#.....#.#.....#
#################
