17 13 0
#################
#...#.........#.#
#.###.###.###.#.#
#.....#...#S#...#
###.###.#.#.#####
#.....#.#.....#G#
###.#######.###.#
#.......#.......#
#####.###.#####.#
#.......#...#.#.#
#.#.#.#.###.#.#.#
#.#.#.#...#...#.#
#################
