17 17 0
#################
#....S..#.......#
#####.#####.#####
#...#.....#.#...#
#.###.#####.#.###
#.......#.#.....#
###.#.###.###.#.#
#...#.....#...#.#
#########.#.#####
#...#.#.....#.#.#
#.#.#.#.#.###.#.#
#.#.#...#.......#
#.###.#.#######.#
#...#.#G#.#.#...#
#.#.#.###.#.#.###
#.#...#.........#
#################
