11 17 0
###########
#.#...#...#
#.###.###.#
#.#.#.#.#.#
#.#.#.#.#.#
#.#...#...#
#.###.#.###
#.#.......#
#.#.###.###
#.#G..#...#
#.###.#####
#..S..#...#
#.#####.#.#
#...#...#.#
#.#####.###
#.........#
###########
