13 15 0
#############
#.....#.....#
#.#####.###.#
#.#..S..#.#.#
#.#.###.#.#.#
#.....#...#.#
#.#####.#.###
#.....#.#.#.#
#####.#####.#
#.......#...#
###.#.#.###.#
#...#G#.....#
#######.#.###
#.......#...#
#############
