15 17 0
###############
#...#.........#
#.#.#######.###
#.#.#.....#..S#
###.#.###.###.#
#...#.#...#...#
#.###.#.#####.#
#.#G..#.#...#.#
#.#.#####.#.#.#
#.........#...#
#.#######.#####
#.#.........#.#
###.###.#.#.#.#
#.....#.#.#...#
#.#.###.###.#.#
#.#...#.#...#.#
###############
