11 17 0
###########
#S....#.#.#
#.#####.#.#
#.....#...#
#.#.#.#.###
#.#.#.....#
###.###.###
#...#.....#
#.#.#####.#
#.#...#..G#
#.#####.#.#
#.....#.#.#
###.###.###
#.#.#.....#
#.#.#.###.#
#...#.#...#
###########
