13 11 0
#############
#.#...#.#...#
#.###.#.#.###
#...........#
###.###.#.###
#.....#.#...#
###.#.###.#.#
#...#..G#.#S#
#####.#.###.#
#.....#.#...#
#############
