17 13 0
#################
#.#.#...#.......#
#.#.#.#.#.#.###.#
#.....#.#.#.#..G#
#.###.#######.###
#.#.....#......S#
#######.#.###.###
#...#...#...#...#
#.###.#####.#.###
#.#.#.......#...#
#.#.#####.#.###.#
#.........#...#.#
#################
