13 17 0
#############
#.#.#.#.....#
#.#.#.#.#####
#.#.....#.#.#
#.#.#.###.#.#
#...#...#.#.#
#######.#.#.#
#...........#
#.###########
#......S....#
###.#.###.#.#
#..G#...#.#.#
###.#.###.###
#...#...#.#.#
###.###.#.#.#
#...#...#...#
#############
