17 17 0
#################
#.......#.....#.#
###.#######.###.#
#.#.....#...#...#
#.###.#####.#.###
#.#...#.....#...#
#.#.###.#######.#
#...........#...#
#.#####.#.###.###
#.#G#...#.....#.#
#.#.#.###.###.#.#
#.#.#.#.#...#...#
###.#.#.#.###.###
#...#...#.#.#...#
#.#.#.#####.#.###
#.#...#......S..#
#################
