17 11 0
#################
#.....#..S#.....#
#.###.#.###.#.###
#...#.#.....#...#
#.#.#####.#######
#.#.........#...#
#.#.#.#.###.###.#
#.#.#G#.#.#...#.#
#.#.###.#.#.#.#.#
#.#...#...#.#...#
#################
