9 9 1
#########
#....G#.#
###.#.#.#
#...#.#S#
#.#####.#
#.......#
#.#####.#
#.....#C#
#########
