9 9 1
#########
#.#S..#C#
#.#.###.#
#.......#
#.#.#####
#.#.#...#
#.#.#.###
#G#.....#
#########
