9 9 1
#########
#.#.#S..#
#.#.###.#
#.......#
#.#.#.###
#.#.#G..#
#.#####.#
#.#....C#
#########
