9 9 1
#########
#...#...#
#.#.###.#
#.#.#.#G#
#.###.#.#
#C..#...#
#.#.#.#.#
#.#...#S#
#########
