9 9 1
#########
#..C..#.#
###.#.#.#
#G..#S..#
###.#.#.#
#...#.#.#
#######.#
#.......#
#########
