9 9 1
#########
#C#S....#
#.#.#.###
#G..#.#.#
#.#####.#
#.......#
###.###.#
#.....#.#
#########
