11 11 1
###########
#.#.#.#...#
#.#.#.#.###
#.......#.#
###.#####.#
#..G#.#...#
###.#.#.#.#
#.#...#.#S#
#.#.#.#.###
#C..#.....#
###########
