11 11 1
###########
#.....#S..#
#.#.#.#.###
#.#.#C#...#
#.###.###.#
#.#.#.#...#
###.#.#.###
#.#.#.....#
#.#.#.###.#
#....G#...#
###########
