11 11 1
###########
#........G#
###.#.#####
#..C#...#.#
#####.###.#
#.#.......#
#.#######.#
#.#.#.....#
#.#.#.#####
#......S..#
###########
