11 11 1
###########
#.....#.#S#
#####.#.#.#
#...#.#G#.#
###.#.#.#.#
#.#...#...#
#.#.###.###
#...#.#...#
#.###.###.#
#......C..#
###########
