11 11 1
###########
#.......#.#
#.#####.#.#
#.#C#..S..#
#.#.#.###.#
#.#.#...#.#
###.###.###
#.#...#G..#
#.#.#####.#
#.........#
###########
