11 11 1
###########
#.#.#...#.#
#.#.###.#.#
#....C..#.#
#.###.#.#.#
#.#...#...#
###.###.#.#
#G#...#.#S#
#.#.#.#.#.#
#...#.#.#.#
###########
