11 11 2
###########
#.......#C#
#.###.###.#
#...#.....#
#.#.###.#.#
#.#.#...#.#
###.#####.#
#.....#S#.#
#.#.###.#.#
#G#.....#C#
###########
