11 11 2
###########
#.....#..C#
#.###.###.#
#...#....G#
#.#####.###
#.#.#.....#
#.#.#.###.#
#.#...#.#.#
#.#.#.#.#.#
#.#S#..C#.#
###########
