11 11 2
###########
#..S#....C#
###.###.#.#
#.......#.#
#.#######.#
#.#...#...#
#####.#.#.#
#..C....#G#
#.###.#.#.#
#.#...#.#.#
###########
