11 11 2
###########
#.#.......#
#.###.###.#
#.#..G#C..#
#.###.###.#
#.......#.#
#####.#.#.#
#C....#.#.#
#.#.#.###.#
#S#.#...#.#
###########
