11 11 2
###########
#.....#...#
#####.###.#
#..C#.....#
#.#######.#
#...#.....#
#.#####.###
#..S..#...#
#.#.#.#.#.#
#.#.#C.G#.#
###########
