11 11 2
###########
#..G.C..#.#
#######.#.#
#.#S#.....#
#.#.#####.#
#........C#
#.###.#.###
#...#.#.#.#
#.###.#.#.#
#.#...#...#
###########
