11 11 2
###########
#.#......S#
#.#######.#
#.#.#.#C..#
#.#.#.#.###
#.#.#.....#
#.#.#.#.###
#.....#G#.#
#.#######.#
#........C#
###########
