11 11 2
###########
#C..#..C..#
#.#####.#.#
#.....#.#.#
#####.###.#
#......S..#
#.#.###.###
#.#.#G....#
###.#.#.###
#...#.#...#
###########
