11 11 2
###########
#C..#C#.#.#
###.#.#.#.#
#..G......#
#.#####.###
#...#.#...#
#.###.###.#
#S..#.....#
#.###.###.#
#...#.#...#
###########
