11 11 2
###########
#.#.#G#...#
#.#.#.###.#
#...#S#...#
###.#.#.###
#..C#C....#
###.#.#.###
#.....#...#
#.#####.###
#.#.......#
###########
