13 13 2
#############
#...#...#...#
#.###.#.###.#
#.....#.....#
#.#.#########
#.#C.C......#
#.#.#########
#.#.#...#G#.#
###.###.#.#.#
#.#.........#
#.#.#.#.#.#.#
#..S#.#.#.#.#
#############
