13 13 3
#############
#.........#.#
#####.#####.#
#...#.#...#.#
#.###.###.#.#
#...#..G#...#
#.#####.#.###
#...........#
#####.#.#####
#.#...#S#.#.#
#.#.###.#.#.#
#C.C..#....C#
#############
