13 13 3
#############
#.#.....#G#.#
#.#.#####.#.#
#......C.C#.#
#######.#.#.#
#.......#...#
#.###.#####.#
#.#S...C#...#
#########.#.#
#.......#.#.#
#.#.###.###.#
#.#...#.....#
#############
