13 13 3
#############
#.#...#.....#
#.###.#.#####
#.#.#..G....#
#.#.#.#####.#
#C....#.....#
###.#####.#.#
#...#...#.#S#
###.#.###.#.#
#.....#C..#.#
###.#####.#.#
#.....#...#C#
#############
