13 13 3
#############
#...#.....#C#
###.#####.#.#
#...........#
###########.#
#..G....#.#.#
#######.#.#.#
#.#C........#
#.#.#####.###
#...#...#.#S#
###.#.###.#.#
#......C#...#
#############
