13 13 3
#############
#...#.....#.#
###.#.###.#.#
#.....#.#...#
#.###.#.###.#
#.#.#...#...#
###.#.###.###
#......C#G..#
###.###.#####
#S....#..C#.#
###.#.#.#.#.#
#...#.#C#...#
#############
