13 13 3
#############
#.#.#.#.#C..#
#.#.#.#.#.###
#..C#..G....#
#.###.#####.#
#..C....#...#
###.###.###.#
#S..#...#...#
#.###.#.###.#
#.#...#.#...#
###.#.#######
#...#.......#
#############
