13 13 3
#############
#...#....C..#
#.#.#.#######
#.#S..#...#.#
#.###.#.#.#.#
#.#G....#.#C#
#.#.#.###.#.#
#.#.#...#.#.#
#.###.#.###.#
#.#.#.#.....#
#.#.#.#####.#
#.#C......#.#
#############
