13 13 2
#############
#.....#.....#
#.#.#.###.###
#.#S#.......#
###.#.#####.#
#...#....G#.#
#######.#####
#...#...#C..#
###.#.###.###
#.#...#....C#
#.#.#.#.#.###
#...#...#...#
#############
