13 13 3
#############
#....C..#.#.#
#######.#.#.#
#..........C#
###.#######.#
#.#.#S......#
#.#####.#####
#.#.#.......#
#.#.#.#.###.#
#.....#...#.#
#.#####.#####
#G#C........#
#############
