13 13 3
#############
#.....#.....#
#####.#.#.#.#
#.....#.#.#.#
#.###.#.#.#.#
#..C#.#.#.#.#
#.#.#.#.#.#.#
#G#.#...#.#.#
###.#####.#.#
#.#..C#...#C#
#.#.#.#####.#
#...#.#....S#
#############
