13 13 3
#############
#.#...#...#.#
#.###.#.#.#.#
#.......#..S#
#####.###.#.#
#....C#C..#.#
#######.#####
#.....#.....#
#####.#.#.###
#.......#...#
#.###.###.###
#.#..C..#G..#
#############
