13 13 3
#############
#...#..S.C..#
###.#.#.#.###
#.#.#.#.#G..#
#.#.#######.#
#.#...#.....#
#.###.###.#.#
#......C#.#.#
#.#.#######.#
#.#.#..C#...#
#.#.#.#.#.###
#.#...#.....#
#############
