13 13 3
#############
#.#.........#
#.#.###.#.###
#C....#.#C..#
#########.#.#
#.......#.#.#
###.#.#.###.#
#...#.#.#...#
###.#.#.###.#
#.#.#.#...#.#
#.#.###.#.#.#
#...#..C#S.G#
#############
