13 13 3
#############
#.........#C#
###.#.#.###.#
#...#.#.#.#.#
###.###.#.#.#
#C....#.....#
###.#######.#
#S#.#..C....#
#.#.###.#.#.#
#....G#.#.#.#
#.#.#####.###
#.#.#.......#
#############
