13 13 2
#############
#.#.#...#.#.#
#.#.#.#.#.#.#
#..G.S#.....#
#####.#####.#
#C....#.#...#
#.###.#.###.#
#...#.#.#...#
###.#.#.###.#
#...#...#...#
#.#.###.###.#
#C#.#.....#.#
#############
