13 13 2
#############
#C#...#.#.#G#
#.###.#.#.#.#
#..C..#.....#
#.#.#.###.###
#.#.#.......#
#.#########.#
#.....#.....#
###.#.###.###
#.#.#.#..S#.#
#.###.#.#.#.#
#.....#.#...#
#############
