13 13 3
#############
#.#.......#.#
#.#.###.#.#.#
#C..#..S#...#
###.#########
#....C.G..#.#
#.#.#####.#.#
#.#.#.#.....#
###.#.#.#.###
#...#...#.#.#
#.###.###.#.#
#C#.....#...#
#############
