11 19 3
###########
#.........#
#.#######.#
#.#...#...#
#.###.###.#
#S#.#....C#
###.#.#####
#.......#.#
###.###.#.#
#G....#.#.#
#####.#.#.#
#.#.#.#..C#
#.#.#.#####
#.#.......#
#.###.###.#
#....C#.#.#
#.#####.#.#
#.#.......#
###########
