11 19 3
###########
#.#.....#.#
#.#.#####.#
#.........#
#####.#####
#.....#...#
#####.#.###
#.#.#.....#
#.#.###.#.#
#.#..C..#.#
#.#.#.###.#
#..C#.#..G#
#.#####.###
#.#.#.#.#.#
#.#.#.###.#
#...#S#...#
#.###.#.#.#
#.......#C#
###########
