17 11 3
#################
#...#......S....#
###.#.###.#.#####
#.#..C#C..#G..#.#
#.###.###.###.#.#
#.......#.#.....#
###.#.#####.#.#.#
#...#...#...#.#.#
###.#.#######.#.#
#C..#...#.....#.#
#################
