19 17 3
###################
#...#...#.........#
###.#.#.###.#######
#...#.#.....#...#.#
#.###.###.###.###.#
#....C..#.........#
#######.#.###.#.###
#C..#...#...#.#...#
#.#.#######.#######
#.#.#S............#
#.###.#.#####.###.#
#...#.#...#.#...#.#
#.#.#.#.###.#####.#
#.#...#.....#.#.#.#
###.###.#.###.#.###
#...#..G#C........#
###################
