11 11 3
###########
#..C..#...#
#.#.###.#.#
#.#.#.#.#C#
#.###.#.###
#......S#.#
#.#.###.#.#
#.#C..#..G#
#.#.#.#.#.#
#.#.#.#.#.#
###########
