17 19 3
#################
#.#.......#...#.#
#.#.#####.###.#.#
#G#.#...#.#...#.#
#.#####.#.#.#.#.#
#......C....#...#
#####.#######.###
#.....#....C#...#
#.###.#.###.#.###
#.#.......#.#...#
#.#######.#######
#.....#...#.#...#
#.###.#####.###.#
#.#..C....#...#.#
###.#########.#.#
#.#........S....#
#.#.###.#########
#.....#.........#
#################
