17 9 2
#################
#.#.............#
#.###########.###
#.#..C..........#
#.#.#.#.#######.#
#...#.#...#..C.S#
#####.#.###.###.#
#.....#...#G#...#
#################
