17 15 3
#################
#.#.#.#.....#...#
#.#.#.#####.###.#
#.#.....#....C..#
#.#####.#.#####.#
#....C.C#G#.#...#
#####.#.###.#.###
#.#...#.......#.#
#.#####.###.#.#.#
#S....#...#.#...#
#.#####.#.###.#.#
#.......#...#.#.#
###.#####.#.#.#.#
#.......#.#.#.#.#
#################
