13 11 3
#############
#..S#...#...#
###.#.###.###
#.......#...#
###.#.#.#.###
#...#.#.#C..#
###.#.#.#.#.#
#C..#.#...#C#
#.#####.###.#
#.....#G#...#
#############
