19 19 3
###################
#C....#.#.......#.#
#.#.###.#.###.###.#
#.#.#.#.#...#.....#
#.###.#.#.#########
#...#.....#G#.....#
###.#####.#.#.###.#
#.#.......#..C#...#
#.###.###.#.#####.#
#.#.....#.......#.#
#.#.###.#.#.#####.#
#...#.#.#.#.....#.#
#####.#.#.#.#.###.#
#...#...#.#.#...#.#
###.#.#####.#######
#..S......#C..#...#
#.###.#.###.#.#.###
#...#.#.#...#.....#
###################
