9 15 3
#########
#C......#
###.#.#.#
#.#.#.#.#
#.###.###
#G..#...#
#.#.#.###
#.#C#.#.#
###.#.#.#
#.#C..#.#
#.#.#.#.#
#.#.#..S#
#.#####.#
#.......#
#########
