15 13 3
###############
#S......#....G#
#######.###.###
#.#.....#.#...#
#.#####.#.###.#
#.....#.......#
#.###.###.#.###
#.#.#.#C#.#..C#
#.#.###.###.#.#
#...........#.#
###.#.#####.#.#
#...#.....#.#C#
###############
