15 19 3
###############
#...#.....#C#.#
#.#####.###.#.#
#.....#.......#
#.###########.#
#S.C#...#.....#
#.###.###.#.###
#.......#C#...#
###.#.#.#.#####
#.#.#.#.#.#.#.#
#.###.###.#.#.#
#.#.....#.....#
#.###.#.###.#.#
#.#G..#.....#.#
#.#.#.#.#.#####
#...#.#.#.....#
#.#######.#####
#.....#.......#
###############
