19 17 3
###################
#.#C......#.....#.#
#.###.#########.#.#
#.................#
###.###.#####.#####
#...#...#.#.......#
###.###.#.###.#.#.#
#.#...#...#C..#.#.#
#.###.###.#####.###
#G#.....#.#...#...#
#.###.###.#.#.###.#
#...#...#.#.#..C#.#
#.#.###.###.###.#.#
#.#.#.....#...#S..#
#.#.#.###.#.###.#.#
#.#...#...#...#.#.#
###################
