11 19 3
###########
#...#.....#
###.###.###
#..S......#
###.#.#.#.#
#...#.#.#.#
#.#####.###
#...#.....#
#####.###.#
#.....#...#
#.###.#.###
#..C#.#...#
#.#.#.###.#
#.#.#C..#G#
#.#.#.#####
#C#.#.#...#
###.###.#.#
#.......#.#
###########
