13 17 3
#############
#.........#.#
#.#####.#.#.#
#.#...#C#..G#
###.#####.###
#C......#...#
#######.#.###
#...#.#.#...#
###.#.#.###.#
#.....#...#.#
#.#.#####.#.#
#.#C#.......#
#.#####.#.###
#.......#...#
###.#####.###
#.......#..S#
#############
