15 19 3
###############
#...#...#.#.#.#
#.###.###.#.#.#
#.........#...#
#.#####.#.#.###
#.#..C..#.#.#.#
#.#.#######.#.#
#.#.....#...#.#
#.###.#.###.#.#
#.#...#..G....#
#######.#####.#
#.......#...#C#
###.#####.###.#
#.#.#....C....#
#.###.#####.###
#.....#.#....S#
#.###.#.###.#.#
#...#.#.....#.#
###############
