9 11 3
#########
#.#..C.C#
#.###.###
#.#.#...#
#.#.#.###
#..S.G..#
#.###.###
#..C#...#
#.#.#####
#.#.....#
#########
