11 13 3
###########
#.#.......#
#.#####.###
#....C....#
#.#.#.#####
#.#.#C#C#.#
###.#.#.#.#
#...#...#.#
#.#####.#.#
#.....#.#.#
#####.###.#
#G.....S..#
###########
