11 19 3
###########
#...#.....#
#.#.#####.#
#.#......G#
###.#.#####
#...#.....#
#.#.###.#.#
#.#...#.#C#
###.#.###.#
#.#.#.#.#.#
#.#.###.#.#
#..S....#.#
###.#####.#
#...#.#.#.#
###.#.#.#.#
#C.C#.....#
#.#.#.#####
#.#.#.....#
###########
