17 9 3
#################
#.......#.......#
#####.#.#.#####.#
#...#S#.#.#G.C..#
#.#.#.#.#####.#.#
#.#.#.#....C..#.#
#.#.#.###.#.#.###
#.#.....#.#C#...#
#################
