9 11 3
#########
#G#.#C#.#
#.#.#.#.#
#..C....#
#.#######
#...#...#
#.###.#.#
#.#...#S#
#.#####.#
#..C....#
#########
