11 15 3
###########
#...#C#...#
#.###.#.###
#.....#.#.#
#.#####.#.#
#..G#C#...#
#.#.#.#.#.#
#S#..C..#.#
#.#####.###
#...#.#...#
###.#.#.###
#...#.....#
#####.###.#
#.....#...#
###########
