17 15 3
#################
#.......#.#G....#
###.#.#.#.#.###.#
#...#C#.....#.#.#
#####.###.###.###
#.......#.....#.#
#####.###.#####.#
#.#C..#C#...#...#
#.#.###.###.#.###
#...#.......#...#
#.#######.###.###
#.....#...#.#.#.#
###.###.#.#.#.#.#
#...#..S#.......#
#################
