13 19 3
#############
#........C..#
#.###.#.#####
#.#...#.#...#
#.#.###.#.###
#.#.#...#...#
#.#.###.###.#
#.#.#G#.#S..#
#####.#.#.###
#.#...#.....#
#.#.#######.#
#..C..#....C#
###.###.#.#.#
#.......#.#.#
#.#####.#.###
#...#...#...#
###.###.###.#
#...#...#...#
#############
