9 9 3
#########
#...#...#
#.#####.#
#G.C#C..#
###.###.#
#.#S#.#.#
#.#.#.#.#
#....C..#
#########
