9 9 2
#########
#..G....#
#####.###
#S....#.#
#.###.#.#
#.#...#.#
###.#.#.#
#..C#..C#
#########
