11 11 3
###########
#...#...#.#
#.#####.#.#
#.......#.#
###.#####.#
#..C.S....#
#.#######.#
#..C..#..C#
#.#.###.#.#
#G#.#...#.#
###########
