11 13 2
###########
#...#.....#
#.#######.#
#.........#
#####.###.#
#....C#.#.#
#####.#.#.#
#.#..C#..S#
#.###.#.###
#.....#...#
###.#####.#
#....G..#.#
###########
