15 17 3
###############
#...........#.#
#####.###.###.#
#C..#.#.#.....#
#.#####.#####.#
#S....#.......#
###.#####.###.#
#.#...#G..#...#
#.#.#.###.###.#
#...#.#.#...#.#
#####.#.#.#####
#........C#...#
###.#######.#.#
#.#.......#.#.#
#.#.#.#######.#
#...#..C......#
###############
