15 11 3
###############
#.............#
#####.#########
#...#....G....#
#.###.#.#.#####
#.....#.#...#.#
#.#.#.#.###.#.#
#.#.#S#.#..C..#
#######.#####.#
#......C#....C#
###############
