13 17 3
#############
#.#.#.......#
#.#.###.#####
#.#...#.#S..#
#.#.###.#.###
#.#G..#.#C..#
#.#.###.#.###
#.#.#...#...#
#.#.#.#####.#
#........C..#
#.#####.#.#.#
#.....#.#.#C#
#.###.#####.#
#...#.#.....#
#.#.###.#.#.#
#.#.#...#.#.#
#############
