19 19 3
###################
#.....#...#.#.#C..#
###.#.###.#.#.###.#
#..C#.#.....#...#.#
#.#########.###.#.#
#...#.#.....#...#.#
###.#.#####.#.###.#
#...#.#.......#.#.#
###.#.###.#####.#.#
#.#.#......C#.....#
#.#.#.###.#####.###
#..G#.#.#.....#.#.#
###.#.#.#######.#.#
#.................#
#.#########.#######
#.#....S#.........#
#.#.###.###.###.###
#.#...#.....#.....#
###################
