9 15 3
#########
#.#...#G#
#.#.###.#
#..C#...#
#.#####.#
#.#.#.#.#
#.#.#.#.#
#...#S..#
###.#.#.#
#C....#.#
###.#.###
#...#.#.#
#.#.#.#.#
#C#.#...#
#########
