15 17 3
###############
#..........S..#
#######.#####.#
#.#.....#.#.#.#
#.#.#####.#.###
#...#...#.#..C#
#.#.#.###.#.###
#.#.#...#.#...#
###.#.#.#.#.#.#
#...#.#.....#.#
###.#.###.#####
#.......#...#.#
#.#####.#####.#
#.#...#..C#...#
###.###.#####.#
#......C.G....#
###############
