19 9 3
###################
#...#...#.........#
###.###.#.#.#####.#
#...#S..#.#.#.#...#
#.#####.#.#.#.#.#.#
#C..#...#.#G#...#.#
###.#.#.#.#########
#.....#..C.....C..#
###################
