17 13 3
#################
#...#...#..G#.#.#
###.###.###.#.#.#
#.#.......#.....#
#.#.#####.#.###.#
#..C#...#.#.#...#
#.###.###.#.#.#.#
#.#.#.#C.C#.#.#.#
#.#.#.###.#####.#
#...#..S........#
###.#####.###.###
#.......#.#.....#
#################
