13 19 3
#############
#..C....#...#
#######.###.#
#.#.#...#...#
#.#.###.###.#
#...#.#.....#
#.###.#.###.#
#...#S#.#..G#
#.###.###.###
#...#...#...#
#.###.###.#.#
#....C..#.#.#
#.#.###.#.###
#.#.#C..#...#
#.###.###.#.#
#...#.....#.#
###.#.#.###.#
#...#.#...#.#
#############
