13 17 3
#############
#....G......#
#######.#.#.#
#...#.#S#.#.#
###.#.#.#####
#.#.....#...#
#.#.#.###.###
#.#.#...#...#
#.#.#.###.###
#...#...#...#
#.#.#######.#
#.#.#.#.....#
###.#.###.#.#
#...#.#C..#.#
#.#.#.###.###
#.#..C...C..#
#############
