15 15 3
###############
#...#.....#...#
#.#####.#####.#
#..G#S........#
#.#.#.###.###.#
#.#...#.#...#.#
###.###.###.###
#...#......C.C#
#.###.#####.###
#.#.....#.....#
#.###.###.#.###
#.#..C..#.#...#
#.#.#.###.#.#.#
#.#.#...#.#.#.#
###############
