19 15 2
###################
#.#G.C..#....S..#.#
#.###.#####.###.#.#
#....C....#.#.#.#.#
#.###.#.#####.#.#.#
#...#.#.....#.....#
#####.###.###.###.#
#.#...#.......#.#.#
#.#.#.#####.###.###
#...#.....#.......#
#####.###.#.#.#####
#.#...#...#.#.....#
#.#.###.#.#.#####.#
#.....#.#.#.#.....#
###################
