11 9 3
###########
#.....#.#.#
###.#.#.#.#
#G..#.#..C#
#.#######.#
#.....#...#
#.#.#####.#
#.#..C.C.S#
###########
