15 13 2
###############
#...........#.#
#.#####.#####.#
#...#C....#.#.#
###.###.###.#.#
#.#...#...#.#.#
#.#.#####.#.#.#
#.#...#.....#.#
#.###.#####.#.#
#.#...#..G.S.C#
#.#.###.#.#####
#...#...#.....#
###############
