17 19 3
#################
#.........#.....#
#####.#.#.#.#####
#...#G#.#.......#
#.###.#####.###.#
#.....#.....#...#
#####.###.#.#.#.#
#.#...#...#.#.#.#
#.#######.#.#####
#.........#.....#
#######.#.###.#.#
#..C#C..#.#...#.#
#.###.#######.###
#.....#S#.....#.#
###.###.###.###.#
#C..#.....#.....#
#.#######.###.###
#...#...........#
#################
