15 17 3
###############
#.......#.....#
###.###.#####.#
#...#C..#.....#
#.#######.###.#
#...#.....#G#.#
###.###.###.#.#
#.......#.#...#
###.###.#.#.#.#
#.#...#...#.#.#
#.#.#.#######.#
#...#...#....C#
###.#.#######.#
#...#...#..S#C#
#.#.#######.#.#
#.#.#.........#
###############
