15 19 3
###############
#.#...#.....#.#
#.###.###.###.#
#C.C..#.#...#.#
#.###.#.#.#.#.#
#...#.....#...#
#####.#.#####.#
#...#.#...#...#
###.#.###.###.#
#.#.#.#...#S..#
#.#.#####.#####
#...#...#.#...#
###.###.#.#.#.#
#...#.......#.#
#.#######.#.###
#.........#...#
#.###.###.#.###
#G.C#...#.#...#
###############
