19 9 3
###################
#....C#.....#G....#
#.###.#.#.#####.###
#C..#.#.#.#...#...#
#####.###.###.#.#.#
#S............#.#.#
###.#.#.###.###.###
#...#.#.#......C..#
###################
