9 19 3
#########
#..C....#
#.#######
#.......#
###.#####
#...#.#.#
#.###.#.#
#.......#
#####.###
#C..#..G#
#.#####.#
#C..#.#.#
###.#.#.#
#.#.....#
#.###.#.#
#.#...#.#
#.#.###.#
#S..#...#
#########
