17 13 3
#################
#...#...#.......#
#.#.###.#####.###
#C#...#.....#...#
###.#.#.#.###.#.#
#...#...#.#...#.#
#.#.#.#.###.#.###
#.#.#.#.....#...#
#.#.#########.#.#
#.#.#....C...G#.#
#.#######.#.#####
#.#.......#S...C#
#################
