17 15 3
#################
#S....#...#.#...#
###.#.#.###.#.###
#...#.#.#...#C..#
#####.#.###.#.###
#.#...#.........#
#.###.#.###.#####
#.....#.#..C....#
#.###.#.###.#####
#.#.#...#.#G#..C#
#.#.#####.#.###.#
#.#...#.......#.#
#.#.#.#####.###.#
#...#.#.........#
#################
