9 17 3
#########
#..C#..C#
###.#.###
#.#.....#
#.#.#.#.#
#...#.#.#
#####.#.#
#G....#.#
#####.###
#.#.....#
#.#.#.#.#
#...#.#.#
###.#.#.#
#S..#.#.#
#.#####.#
#.#C....#
#########
