13 9 3
#############
#C...C..#...#
#.#######.#.#
#...#...#C#.#
#.#####.#.###
#.#.#..S....#
#.#.#.#.#.#.#
#.....#.#G#.#
#############
