15 9 3
###############
#....G#..S....#
#####.#.###.###
#.#C#.....#...#
#.#.###.###.#.#
#C#...#..C#.#.#
#.###.#.#.#####
#.......#.....#
###############
