19 11 3
###################
#...#.....#S......#
#.#####.###.###.###
#.#.....#.#.#.#..C#
#.#####.#.#.#.#.###
#.#.......#G#...#.#
#.###.###.#.#####.#
#...#...#......C.C#
#.###.#.#.###.###.#
#.....#.#.#.....#.#
###################
