11 9 2
###########
#S#.......#
#.#.#######
#.#.......#
#.#######.#
#.....#...#
#####.#.#.#
#..C.C..#G#
###########
