13 19 3
#############
#.....#..S#.#
#.#.#.###.#.#
#.#.#...#.#.#
#.#.#####.#.#
#.#.........#
#.###.#######
#.#C....#C..#
###.###.#.###
#...#.#.....#
#####.###.#.#
#...#.....#.#
###.#.#######
#.........#C#
#.#.###.#.#.#
#.#.#G..#...#
###.#.#.#####
#...#.#.....#
#############
