9 15 3
#########
#...#C#.#
###.#.#.#
#....S#.#
#.#####.#
#....G..#
#.#.###.#
#.#...#.#
###.###.#
#C....#C#
#.#####.#
#.....#.#
#.#.#.#.#
#.#.#.#.#
#########
