19 17 3
###################
#S#.#.#.........#.#
#.#.#.#.#.#####.#.#
#.#...#.#.#.......#
#.#.#.#####.#.#####
#...#...#...#.#...#
#.#.#####.#####.#.#
#.#.#...#...#...#.#
#.#.#.###.###.#.###
#.#...#....C#.#.#.#
###.#.###.#####.#.#
#.#.#........C....#
#.###.#.###.#.#####
#.....#...#.#.#...#
#.#.###.#.###.#.#.#
#.#...#.#G.C#...#.#
###################
