13 11 2
#############
#C#.......#.#
#.#.#.###.#.#
#.#.#.#..E#.#
#.###.#.###.#
#.....#.#.#.#
#####.###.#.#
#...........#
#.#.#.#####.#
#G#.#.#S...C#
#############
