13 13 2
#############
#S......#...#
#.#.#.###.###
#.#.#.....#.#
#######.###.#
#.....#C....#
#.#####.#####
#E.......G..#
###.#.#######
#...#.......#
#.#####.#.###
#....C#.#...#
#############
