13 17 2
#############
#.#.#...#...#
#.#.###.#.###
#.#...#.....#
#.#.###.###.#
#.#...#.#E..#
#.###.#.#.#.#
#.#.....#.#.#
#.#.###.#####
#...#....G..#
#.#######.#.#
#S#...#.#.#.#
#####.#.###.#
#...#......C#
###.#.###.#.#
#..C..#...#.#
#############
