11 9 2
###########
#....E...C#
#####.#.#.#
#..C..#G#.#
#.#.#######
#.#.......#
#.#.#####.#
#.#.#S....#
###########
