9 13 2
#########
#G...C..#
#.#####.#
#.#.....#
#.#.#.###
#.#.#.#.#
#####.#.#
#..S....#
###.#####
#C..#E..#
#.###.#.#
#.....#.#
#########
