13 15 2
#############
#E#.#...#..S#
#.#.###.#.#.#
#....C#...#.#
###.#.###.#.#
#.#.#.#...#.#
#.#.###.###.#
#..C..#...#.#
#####.#.###.#
#.#.#...#...#
#.#.###.#####
#G..........#
#.#.###.#.###
#.#...#.#...#
#############
