13 9 2
#############
#....C..#...#
###.#####.###
#...#.#E#...#
###.#.#.###.#
#.#C..#....S#
#.#.#.#.###.#
#...#...#..G#
#############
