13 9 2
#############
#.#S.C..#E..#
#.#.###.#.###
#.#..G#.....#
#.#####.###.#
#C........#.#
#####.#####.#
#.........#.#
#############
