9 17 2
#########
#C#.....#
#.#.###.#
#.....#.#
#.#######
#.#.....#
#.#.#.###
#..S#...#
#####.#.#
#....E#.#
###.###.#
#.....#C#
#.#####.#
#..G..#.#
#######.#
#.......#
#########
