15 9 2
###############
#...#..C#..E..#
#.#####.#.#.###
#C#......G#.#.#
#.#####.###.#.#
#.......#.#...#
#.#.###.#.###.#
#S#...#.....#.#
###############
