13 9 2
#############
#C.G#C#.....#
#.#.#.#.###.#
#.#...#.#...#
#.###.#.###.#
#.#E....#..S#
#####.#.#.###
#.....#.#...#
#############
