11 11 2
###########
#.#.#.#.#.#
#.#.#.#.#.#
#..G#.#.#.#
###.#.#.#.#
#.......#E#
#.#######.#
#C.S......#
#####.#.###
#.....#..C#
###########
