9 9 2
#########
#.......#
#####.#.#
#S#.#.#E#
#.#.###.#
#..G.C..#
###.#.#.#
#...#C#.#
#########
