9 9 2
#########
#C..#S#.#
#.#.#.#.#
#.#.....#
###.#.###
#..C#..G#
#.#.###.#
#.#..E#.#
#########
