11 15 2
###########
#....C#...#
#####.###.#
#..G#E....#
#.#.#.#####
#.#.#..C..#
#.#.#.#.#.#
#.#...#.#.#
#.###.#####
#.#.......#
#.#.###.#.#
#S#.#...#.#
#.#####.###
#...#.....#
###########
