11 11 2
###########
#..C......#
###.#.#####
#.#.#.#...#
#.###.#.###
#..S....#.#
#.#.#####.#
#.#C#E..#G#
###.#.#.#.#
#.....#...#
###########
