11 15 2
###########
#S#...#...#
#.###.###.#
#.........#
#####.###.#
#C.E#.#...#
#.#######.#
#.....#...#
#####.#.###
#.#.#G....#
#.#.#####.#
#.#...#C..#
#.#.#.#.###
#...#.....#
###########
