11 11 2
###########
#S.......C#
#.#########
#...#.....#
#.#.#.#####
#.#....C#E#
#.#.###.#.#
#.#G#.....#
###.#####.#
#...#.....#
###########
