9 9 2
#########
#.#.....#
#.#.#.###
#.#.#...#
#.###.#.#
#C.C.G#.#
#.#.#.#.#
#.#S#.#E#
#########
