11 9 2
###########
#.#...#C..#
#.#.#####.#
#C.......G#
#.#.#######
#.#.....#E#
###.#.#.#.#
#...#S#...#
###########
