11 15 2
###########
#...#.....#
###.#.#####
#..E..#.#.#
###.###.#.#
#...#.#C..#
#.###.###.#
#...#....C#
#.#.#.#####
#.#...#...#
#.#######.#
#.#..G#...#
#.#.###.###
#S........#
###########
