13 13 2
#############
#...#...#..E#
#.#####.###.#
#.#...#.....#
#.#.#####.###
#.....#G....#
#.#######.###
#.#.....#...#
#.#####.#.###
#S#C....#...#
#.#.#.###.#.#
#...#.....#C#
#############
