13 15 2
#############
#.#..E.G#.#.#
#.#.#.###.#.#
#S#.#.#.....#
#.###.#.#.###
#.#.#...#...#
#.#.#.#######
#C#.#.....#C#
#.#.#.#.###.#
#.....#.....#
###.###.#####
#...#.......#
#.###.#####.#
#.#.....#...#
#############
