17 15 2
#################
#.........#C....#
#######.#.###.###
#.#.....#.......#
#.###.#####.###.#
#...#.#.#.#...#.#
#.#.#.#.#.#######
#.#.......#.....#
#.###.###.#.#####
#.#..C..#..G....#
#.#############.#
#...#S#...#E....#
#.#.#.#.###.#.###
#.#...#.....#...#
#################
