11 17 2
###########
#.#.#...#.#
#.#.#.###.#
#.#G#....C#
#.#.#.#.#.#
#.#..S#.#.#
#.#######.#
#.#.#.....#
#.#.#.#####
#........E#
###.#######
#.#.....#.#
#.#.#####.#
#....C#.#.#
###.#.#.#.#
#...#.....#
###########
