9 13 2
#########
#......G#
#.#####.#
#.#...#S#
#####.#.#
#.#C...C#
#.###.###
#...#...#
#.###.#.#
#.....#.#
###.###.#
#.....#E#
#########
