17 17 2
#################
#.......#...#.#.#
#######.###.#.#.#
#.#....S..#...#.#
#.###.###.#.###.#
#.....#...#.....#
#.###.#.###.###.#
#C..#C#E....#...#
#.#####.###.#.#.#
#.#.......#.#.#.#
#.#####.###.#.#.#
#.#.....#...#.#.#
###.#####.###.###
#G..#.#...#.#...#
###.#.###.#.#####
#.......#.......#
#################
