9 17 1
#########
#..C#..G#
###.#.###
#.#.#.#.#
#.#.#.#.#
#.#.#...#
#.#.###.#
#.#....S#
#.###.#.#
#.#.#.#.#
#.#.#.#.#
#.....#.#
#.#####.#
#E....#.#
###.#.#.#
#...#.#.#
#########
