13 9 2
#############
#.#...#.#...#
#.#.###.#.#.#
#C#.#.#...#.#
#.#.#.###.#.#
#.#..G..#.#S#
#.#.###.#.###
#.....#..E.C#
#############
