11 17 2
###########
#S..#E.C#.#
#.###.###.#
#.........#
#.#.#.#####
#.#.#.#...#
#.#####.###
#G..#.....#
###.#.#####
#.........#
#.#####.###
#.....#.#.#
#.###.#.#.#
#..C#.#.#.#
#.#.#####.#
#.#.......#
###########
