9 11 2
#########
#S..#E.G#
#.###.###
#.....#.#
###.#.#.#
#C..#.#.#
###.#.#.#
#...#...#
#.#####.#
#.#C....#
#########
