17 9 2
#################
#.#.#...#.#.....#
#.#.#.###.###.###
#C#.#.#...#.....#
#.#.#.#.#######.#
#..G..#E#.#.#...#
#.###.#.#.#.#.#.#
#.#......C....#S#
#################
