17 11 2
#################
#.#.#C..#.#...#.#
#.#.###.#.#.###.#
#...#.....#..C.G#
###.#.#.#.###.###
#...#.#.#.......#
###.#####.###.###
#...#S....#E#.#.#
###.#.#####.#.#.#
#.......#.......#
#################
