13 17 2
#############
#...#......E#
#.#########.#
#.....#.....#
#####.#.#.###
#S......#...#
###.#.###.#.#
#...#.#.#.#.#
#.#.###.#.###
#.#C....#G..#
#.#######.###
#.#.........#
###.#.#.###.#
#.#.#.#...#.#
#.###.#.#####
#....C#.....#
#############
