17 9 2
#################
#..........C....#
#.###.#####.#####
#S#..G....#.#..C#
###.###.#######.#
#.#.#E..........#
#.#.#.#.###.#.###
#...#.#...#.#...#
#################
