13 11 2
#############
#.#..C.C..#.#
#.#####.###.#
#...#.....#.#
###.###.###.#
#..E...G..#.#
#.#####.###.#
#.#.#...#.#.#
###.#.###.#.#
#........S..#
#############
