17 15 2
#################
#.........#.....#
#####.#########.#
#...#.#.#.#C#...#
###.#.#.#.#.###.#
#...#.#...#...#.#
###.#.#.#.###.#.#
#C#.#.#.#.#.....#
#.#.#.###.#.#####
#.#.....#S.E#...#
#.###.#.#.#.#.#.#
#...#.#...#...#.#
###.#.###.#######
#..G....#.......#
#################
