13 15 2
#############
#.#.........#
#.#.#.#####.#
#...#...#.#.#
#####.###.#.#
#.........#.#
###.#.###.###
#.#.#..C#.#.#
#.#.###.#.#.#
#..E#...#..G#
#.#.#######.#
#S#.#.#.#.#C#
#.###.#.#.#.#
#...#.......#
#############
