9 11 2
#########
#C...G#.#
###.###.#
#...#...#
#.#####.#
#...#C..#
#.###.#.#
#..E#.#.#
###.#.#.#
#S....#.#
#########
