13 17 2
#############
#.#.#C#.....#
#.#.#.###.###
#.#.#.#....E#
#.#.#.###.###
#...........#
#######.#####
#...........#
#.#######.#.#
#....G#...#.#
#.#######.###
#.......#.#.#
###.#.###.#.#
#...#.#C#..S#
###.#.#.#.###
#...#.#.....#
#############
