9 15 2
#########
#.......#
###.#####
#.#...#.#
#.#.###.#
#.......#
#.#.#.###
#.#G#E..#
#.###.###
#S#...#C#
#.###.#.#
#..C#...#
###.###.#
#...#...#
#########
