15 17 2
###############
#.#.....#....G#
#.#.###.###.###
#.#.#.#.....#.#
#.###.###.###.#
#......E..#.#.#
#.###.#.#.#.#.#
#.#.#.#.#.....#
###.#####.#.#.#
#....S..#.#.#.#
#.#.#.#.###.###
#.#.#.#.....#.#
###.#####.###.#
#.#...#.#....C#
#.#.#.#.#####.#
#...#....C#...#
###############
