11 9 2
###########
#.#..G#...#
#.#.#####.#
#...#C#.#.#
#.#.#.#.#.#
#E#.#.....#
#.###.#####
#..S...C..#
###########
