11 11 2
###########
#..E....#.#
#.#.###.#.#
#.#C.C#S..#
###.###.###
#.#...#.#.#
#.###.###.#
#......G..#
#####.#####
#.........#
###########
