15 11 2
###############
#..S#.#.....#.#
#.###.#.#####.#
#...........#.#
#.#####.#.#.#.#
#...#...#G#.#.#
#.#######.#.#.#
#C#...#.#.#...#
###.###.#####.#
#..C.E........#
###############
