13 15 2
#############
#.....#.#..C#
#####.#.#.###
#...#.#.....#
#.#.#.###.###
#.#.#.#.....#
###.#.###.#.#
#C........#.#
###.#.#.#####
#.#.#.#.....#
#.#.###.#####
#E.S#.....#.#
###.#.#####.#
#...#....G..#
#############
