11 17 2
###########
#.#...#...#
#.#.###.###
#G..#S....#
###.#.#.###
#E....#.#C#
#####.#.#.#
#.....#.#.#
###.#.###.#
#...#.#.#.#
#.###.#.#.#
#...#.....#
###.#.#.###
#..C#.#...#
#######.###
#.........#
###########
