15 9 2
###############
#...#.#.#.....#
#.###.#.#####.#
#G..#.#....S#.#
#.###.#.###.#.#
#C..#E..#.....#
#.#.###.#.#.#.#
#.#C....#.#.#.#
###############
