15 15 2
###############
#..C..#.......#
#.#.#####.#####
#.#.....#.....#
###.#####.###.#
#.#...#.....#.#
#.#.###.#######
#.#S....#.#...#
#.###.###.#.###
#.#...#.#.....#
#.###.#.###.###
#.....#..E#...#
###.###.#.#.###
#....G..#....C#
###############
