13 13 2
#############
#.....#.#G#.#
###.#.#.#.#.#
#.#.#.....#.#
#.#.#.###.#.#
#..C#...#...#
###.#######.#
#...#...#C.E#
#####.###.#.#
#.........#.#
#.#.###.#.#.#
#.#..S#.#.#.#
#############
