17 15 2
#################
#.#.#...#C#.....#
#.#.###.#.#####.#
#.......#.#..G..#
#.#####.#.#.###.#
#.#S#.........#.#
###.#####.###.#.#
#E....#.#...#.#.#
#####.#.#.###.#.#
#...#.......#.#.#
###.#######.###.#
#...........#...#
###.#.#.#########
#...#.#....C....#
#################
