13 11 2
#############
#.#G#C#.....#
#.#.#.#####.#
#E#...#.#...#
#.###.#.###.#
#.......#...#
#.#.#.#.###.#
#.#.#.#.#...#
#.###.#.#.###
#.#...#..S.C#
#############
