15 11 2
###############
#.#.....#G#C..#
#.#.#####.#.#.#
#.....#S#...#.#
#.###.#.#####.#
#.#.#......E#.#
###.#.#####.#.#
#.#...#C......#
#.#.#.#.#.#.#.#
#...#.#.#.#.#.#
###############
