11 11 1
###########
#......G..#
###.###.###
#.....#...#
#.#####.###
#.....#.#.#
#.###.###.#
#...#.#.#E#
###.#.#.#.#
#C..#....S#
###########
