11 13 2
###########
#..C#S..#.#
#.###.#.#.#
#.....#...#
#######.###
#.#..E#C..#
#.#.###.###
#.........#
###.#######
#..G#...#.#
#.###.#.#.#
#.....#...#
###########
