17 9 2
#################
#..G#...........#
#.###.#.#.#####.#
#.#C#.#.#.#.#.#.#
#.#.#######.#.#.#
#..S...........E#
###.###.###.#.###
#...#....C#.#...#
#################
