17 11 2
#################
#.....#.....#...#
#.#.#.#.#.###.#.#
#.#.#.#.#.#...#.#
#####.###.#.###.#
#E..#.#..C#...#S#
###.#.###.#.#.#.#
#..C........#.#.#
#.#.#.###.#####.#
#.#.#...#G#.....#
#################
