15 13 2
###############
#.....#C#.....#
#.###.#.###.###
#.#.#.#.#...#.#
#.#.###.#.#.#.#
#.#......E#..G#
#.#####.#.###.#
#.#S..#.#.#.#C#
#.#.###.###.#.#
#.#.#.....#...#
#.#.###.#.#####
#.......#.....#
###############
