13 11 2
#############
#.....#.#C..#
#####.#.#.###
#.........#.#
#.#.#.#####.#
#.#.#..G..#.#
###.###.###.#
#.#.#.#..E..#
#.#.#.###.#.#
#C..#S....#.#
#############
