15 9 1
###############
#.#.#.#...#.#.#
#.#.#.#.#.#.#.#
#E#S#...#.....#
#.#.###.#####.#
#C......#...#.#
#.###.#.###.###
#..G#.#.......#
###############
