11 17 2
###########
#...#.#C..#
#.###.###.#
#........E#
#.###.#####
#C..#.#...#
#.#####.###
#...#...#.#
#.#####.#.#
#.#.#....G#
#.#.#.#####
#.........#
#.###.#####
#.#.......#
#.###.#####
#...#....S#
###########
