15 9 2
###############
#.#....G......#
#.###.#.#.#.#.#
#...#.#.#.#.#.#
#.#####.###.###
#E.....C#S..#.#
###.#######.#.#
#........C#...#
###############
