13 9 2
#############
#...#.....#.#
#.#.#.#####.#
#.#.....#..S#
###.#.#.#.###
#..G#.#E..#.#
#.###.#.###.#
#C#C..#.....#
#############
