9 17 2
#########
#...#...#
#.###.###
#...#..G#
#.#####.#
#.#.....#
#.#.###.#
#...#C..#
#.#####.#
#..S..#.#
#.#####.#
#.#.....#
#.#.###.#
#C#...#.#
#.#.#####
#.#E....#
#########
