15 17 2
###############
#.#.#.#.#.#...#
#.#.#.#.#.###.#
#.....#C#..S..#
#.###.#.#####.#
#.#...#.....#.#
###.###.#.#.#.#
#.#.#.#.#E#...#
#.#.#.#.###.###
#.#...#...#...#
#.###.#######.#
#...#.......#.#
###.###.###.#.#
#.......#G.C..#
#.###.#########
#.#...........#
###############
