11 15 2
###########
#.......#.#
###.###.#.#
#.#.#.#.#.#
#.###.#.#.#
#...#C....#
#.#.#####.#
#.#C..#...#
###.###.###
#.#G..#...#
#.#.#.###.#
#.#.#.#...#
#.###.#.###
#E.S......#
###########
