9 13 2
#########
#.#...#.#
#.###.#.#
#.#.#S#.#
#.#.#.#.#
#.#..E#C#
#.#.###.#
#......G#
#.###.###
#...#..C#
#.###.###
#...#...#
#########
