15 17 2
###############
#S...C#.#...#C#
###.###.#.###.#
#.....#.....#.#
###.#.#.#####.#
#.#.#.#.#.....#
#.#.###.#.#####
#.#.#.#.....#.#
#.#.#.#.#.###.#
#.#.#...#.....#
#.#.#####.#####
#.....#.......#
###.#####.###.#
#....G......#.#
#.###.#####.###
#...#...#E....#
###############
