11 13 2
###########
#.#.......#
#.#####.#.#
#G...S#.#.#
###.#.#.###
#...#E#...#
#.#.#.#.#.#
#.#C#..E#.#
#####.#####
#.........#
###.#.#####
#...#....C#
###########
