15 9 2
###############
#.......#E....#
#######.#.#.###
#.........#.#C#
#####.#.###.#.#
#E..#.#S#G....#
###.#.#.###.#.#
#.....#...#.#C#
###############
