11 17 2
###########
#.......#.#
#.#.#####.#
#.#.......#
#.###.###.#
#...#...#.#
#########.#
#.#.#..S#.#
#.#.###.#.#
#...#.#.#.#
###.#.#.#.#
#.......#.#
###.###.#.#
#..C#E.C..#
###.#####.#
#......E#G#
###########
