11 9 2
###########
#..C#..E#.#
###.#.#.#.#
#...#.#...#
###.#.###.#
#.#.#.#.#G#
#.#.#.#.#.#
#C.....S#E#
###########
