11 9 2
###########
#.......#C#
#.#######.#
#G......#.#
#######.#.#
#S...C....#
#.###.#.#.#
#..E#.#.#E#
###########
