17 17 2
#################
#....E#..C#.....#
#.###.###.#.#####
#.#.....#.......#
#.#.#.#.#.#######
#.#.#.#..E#.#...#
#.#####.###.#.###
#..S#.........#.#
#.#.###.###.###.#
#.#...#.#..C..#.#
###########.###.#
#.....#.#...#.#.#
###.###.#.###.#.#
#G....#.........#
#.#.###.#.#######
#.#.....#.......#
#################
