13 17 2
#############
#..........C#
###.#.#####.#
#.#.#.....#.#
#.###.#.#.###
#...#.#.#.#.#
#.#.###.#.#.#
#.#.....#.#.#
#######.###.#
#S........#.#
###.#.#####.#
#E..#E......#
#.#.#.#####.#
#.#.#.#G....#
###.###.###.#
#...#C..#...#
#############
