9 13 2
#########
#...#..E#
#.###.###
#...#..G#
#.###.#.#
#..S..#.#
#.#.#####
#.#C#...#
###.#.###
#....E..#
#.#.#.#.#
#.#.#.#C#
#########
