11 9 2
###########
#C.E.S..#.#
#.#######.#
#.....#..G#
#.#######.#
#..E#.....#
#.###.#####
#C........#
###########
