17 13 2
#################
#...#E..........#
###.###.#.#.#####
#E#C#...#.#.....#
#.#.###.#.#.#####
#...#.#.#.#...#.#
#.###.#######.#.#
#C#...#.....#S#.#
#.#.#.###.###.#.#
#...#.#.........#
#.###.###.###.###
#.#......G#.....#
#################
