15 9 2
###############
#.#.#E..#...#.#
#.#.###.#.#.#.#
#E#....C..#...#
#.#.#.#######.#
#..C#.....#...#
###.#######.#.#
#..G.S....#.#.#
###############
