13 15 2
#############
#.#.....#...#
#.#.#.###.###
#C#.#.#.....#
#.#.#.#####.#
#...#.#.....#
#.#.#####.#.#
#.#E.G..#E#.#
#####.#####.#
#.......#...#
#.#####.#.###
#.....#....C#
#########.###
#..........S#
#############
