17 15 2
#################
#.#G#.#.......#.#
#.#.#.#####.#.#.#
#...#...#.#.#.#.#
###.#.###.#.#.#.#
#.#....C#.#.#...#
#.###.#.#.#####.#
#C..#.#...#.#..E#
###.#####.#.#.#.#
#.........#...#.#
#.#######.#.#.#.#
#.......#...#.#.#
###.#.#####.#.#.#
#...#E.S#...#.#.#
#################
