17 11 2
#################
#..E........#.#S#
#.#.#####.###.#.#
#.#.#.#.#.#.....#
###.#.#.#.#####.#
#..E....#.#.....#
#.#.###.#.#.###.#
#.#.#C#.#C..#...#
#.#.#.#########.#
#G#.#...........#
#################
