13 15 2
#############
#....C#..E..#
###.#####.#.#
#...#.....#.#
#.#####.#####
#...#....S..#
###.#.#.#.###
#.#E#.#.#...#
#.#.#.#.#.#.#
#...#.#.#.#.#
#.#.#.###.#.#
#.#...#..G#.#
#.#.#.#.#.###
#.#C#.#.#...#
#############
