9 17 2
#########
#.#S#...#
#.#.###.#
#......G#
#####.#.#
#...#.#.#
###.#.###
#.#E#...#
#.#.#.#.#
#..E..#.#
###.###.#
#..C#...#
#.###.#.#
#.#...#.#
#.###.###
#C..#...#
#########
