13 11 2
#############
#.#.#.#...#E#
#.#.#.###.#.#
#.#...#C#..S#
#.#.###.#.#.#
#.....#E#.#.#
###.#.#.#.###
#...#.......#
#######.#.#.#
#....C.G#.#.#
#############
