11 9 2
###########
#..E#E.S..#
#.#.#####.#
#C#....C#.#
#######.#.#
#.......#.#
###.###.#.#
#G..#.....#
###########
