11 17 2
###########
#.....#...#
#.#.#.#.###
#.#.#.....#
###.#.#.###
#E..#.#E#.#
###.#####.#
#C..#..C.S#
#.#.#.#.###
#.#...#.#.#
###.#.###.#
#.#.#.#.#.#
#.#.###.#.#
#.#...#...#
#.#.#.#.###
#...#..G..#
###########
