11 13 2
###########
#....E#...#
###.#.###.#
#...#.#C#.#
#.#.###.#.#
#S#..E#...#
###.#####.#
#...#....C#
###.###.###
#...#.#...#
###.#.#.#.#
#..G....#.#
###########
