11 9 2
###########
#.#C....#.#
#.#.#.###.#
#E#E#G.S..#
#.#####.#.#
#.#..C..#.#
#.#.#.#.#.#
#...#.#.#.#
###########
