17 11 2
#################
#.#...#.#...#E..#
#.#.###.#.#.#.###
#E#......C#...#.#
#.###.#.#.###.#.#
#S..#.#G#...#...#
#.###.#########.#
#.#...#......C..#
#.#######.#####.#
#...........#...#
#################
