15 13 2
###############
#C...E..#.#.#.#
#.#####.#.#.#.#
#.....#...#C#.#
###.###.#.#.#.#
#...#...#.....#
#####.#.#######
#.#S#.#.......#
#.#.###.#####.#
#...#...#.....#
#.#.#####.#####
#.#G.........E#
###############
