9 13 2
#########
#.......#
#####.#.#
#E#..C#.#
#.###.#.#
#.#...#.#
#.#.#.#.#
#.#.#.#.#
#.#.#####
#E.G#S..#
###.#.#.#
#C....#.#
#########
