11 13 2
###########
#.#.......#
#.###.#.###
#....E#...#
#.#######.#
#S#.#E#...#
#.#.#.#.#.#
#.#....G#C#
#######.#.#
#.......#.#
#####.###.#
#....C..#.#
###########
