15 11 2
###############
#.#.#...#.#...#
#.#.###.#.#.###
#..C...G......#
#.#.###.#####.#
#.#.#.#E.S#...#
#####.#.#####.#
#.....#E#.#...#
#####.###.#.###
#........C....#
###############
