15 11 2
###############
#.........#..G#
#.#.#####.#.###
#.#....C#...#.#
###.#####.###.#
#.....#.....#.#
#.#.#.#.#.###.#
#C#.#.#.#E...E#
#####.#.#####.#
#....S#.....#.#
###############
