11 11 2
###########
#.#.#S#...#
#.#.#.#.###
#...#...#.#
#.#.###.#.#
#C#.#...#G#
#.#####.#.#
#..E......#
#####.#####
#C.......E#
###########
