17 15 2
#################
#.........#...#.#
#######.###.###.#
#.#.#..S..#.....#
#.#.###.###.#.###
#.........#.#.#.#
#######.#####.#.#
#...#E.G#...#C..#
###.#.#.###.###.#
#.....#C........#
#.###.###.#####.#
#...#.#.....#.#.#
###.#.#.#.###.###
#...#E#.#.......#
#################
