11 15 2
###########
#.#.......#
#.#.#######
#..C#.....#
#.###.###.#
#.#..S#...#
#.#.###.###
#G..#E....#
#.#.#######
#.#..E..#C#
#####.###.#
#.#.......#
#.#.#.#####
#...#.....#
###########
