17 13 2
#################
#...#......E#.#.#
#.#.#.#######.#.#
#.#...#...#.....#
#.#######.###.###
#.....#.#.#.....#
###.#.#.#.#.#.###
#...#S...G..#...#
###.#.#.###.#.###
#.#.#.#.#...#...#
#.###.###.###.###
#..E...C#.#C....#
#################
