17 15 2
#################
#C.........G#...#
#######.#####.###
#......C#.......#
#.#.#.#######.###
#.#.#.#.....#S..#
#.###.###.#.#.###
#.#..E..#.#...#.#
#.#####.#####.#.#
#E#...#.....#...#
###.###.###.#.#.#
#.#.......#...#.#
#.#.#######.###.#
#...#.......#...#
#################
