9 9 2
#########
#G......#
###.#####
#.......#
#######.#
#C.S#C..#
###.###.#
#E.....E#
#########
