11 9 2
###########
#...#.#G.C#
#.###.#.###
#..S#.....#
#.#.###.#.#
#.#...#.#E#
#####.#.###
#E...C....#
###########
