9 17 2
#########
#...#.#.#
#.###.#.#
#...#.#.#
###.#.#.#
#.#....E#
#.#.#####
#...#.#E#
#.#.#.#.#
#.#G#...#
###.#.###
#S..#.#.#
###.#.#.#
#....C.C#
###.#.#.#
#...#.#.#
#########
