13 13 2
#############
#G..#.......#
#.###.###.###
#.#.....#...#
#.#.#######.#
#.....#...#.#
#.#####.###.#
#..C#.#..E#C#
###.#.###.###
#.....#..E..#
#.#.###.###.#
#.#.......#S#
#############
