9 17 2
#########
#C#.....#
#.#.#.#.#
#.#.#.#S#
#.###.###
#..G..#.#
#.#####.#
#E#.#..E#
#.#.#.###
#.#.....#
#.#.#####
#.#.....#
#.###.#.#
#C....#.#
#.#####.#
#.....#.#
#########
