17 17 2
#################
#...#.#...#.....#
#.###.###.#.#.###
#.#..E....#.#...#
#.#######.#.###.#
#E..#.#.#C#...#.#
#.###.#.#.#.#####
#.#.........#...#
#.#.###.#.###.###
#.#.#...#.#S#...#
#.#.###.###.###.#
#.....#.........#
#.#############.#
#..C#.#.....#...#
#.#.#.#.###.###.#
#.#.......#G..#.#
#################
