17 9 2
#################
#.#.#........E#.#
#.#.#.#.#.#.###.#
#.#...#C#.#..G..#
#.###.#####.###.#
#.#.#.#...#...#.#
#.#.###.#####.#.#
#E.....C...S..#.#
#################
