17 17 2
#################
#.......#.....#.#
###.###.#.#####.#
#.....#.#..E..#.#
#####.#.###.###.#
#.#...#...#.#...#
#.#######.#.###.#
#..G........#...#
###.#.###.###.#.#
#...#.#.....#.#.#
#.#.#.###.#####.#
#.#S#.#.......#.#
#######.#######.#
#E....#...#.....#
#.###.#.#.#.#####
#.#.....#..C.C..#
#################
