17 11 2
#################
#..C#.#.#.......#
#.###.#.###.#.###
#.#E........#...#
#.###.#.#.###.#.#
#.....#.#C#.#.#G#
#.#.#####.#.#.###
#.#...#.....#...#
#.#.###.#.###.###
#.#.#S..#..E#...#
#################
