11 11 2
###########
#.........#
#.#.#######
#.#.#S....#
###.###.###
#..E...E..#
###.#####.#
#.#..G#C..#
#.#.###.###
#..C..#...#
###########
