9 15 2
#########
#..E..#G#
#.#.###.#
#.#...#C#
#.#.###.#
#.#...#.#
#.###.#.#
#...#E..#
#####.###
#.#...#.#
#.#.###.#
#..S....#
#.#####.#
#.....#C#
#########
