15 15 2
###############
#.#.......#.#G#
#.###.###.#.#.#
#.....#.....#.#
#######.###.#.#
#....S....#.#.#
#####.#.#.#.#.#
#.....#.#.#E#.#
#######.###.#.#
#.......#...#E#
###.#####.###.#
#...#..C#C..#.#
#.#.#.#.#.###.#
#.#.#.#.......#
###############
