9 13 2
#########
#.#....S#
#.#.#####
#.....#.#
###.###.#
#......E#
#.#####.#
#.#..G..#
#####.###
#..E.C..#
#.#####.#
#.#C....#
#########
