9 17 2
#########
#.#.....#
#.#.###.#
#.#..C#E#
#.#.#.###
#...#...#
#######.#
#.......#
#.#####.#
#.#...#G#
#.#.###.#
#.....#.#
###.#.###
#S..#...#
#.#.#.###
#.#C#..E#
#########
