17 15 2
#################
#...#...#C......#
###.#.#.#######.#
#.#...#.........#
#.#######.#####.#
#.#...#.#....E#.#
#.#.###.#######.#
#.....#.....#...#
###.#.#.#####.###
#.#.#...#...#C..#
#.#####.#.#.#.###
#S#...#..E#.....#
#.###.#.#####.###
#......G..#.....#
#################
