13 11 2
#############
#C..#..C....#
###.#.###.###
#..E.S#.....#
###.###.#.#.#
#..G#...#.#.#
###########.#
#...#......E#
###.#.###.#.#
#.....#...#.#
#############
