13 13 2
#############
#.......#...#
#####.###.###
#.#......S#.#
#.###.#.###.#
#..C#.#....C#
###.#####.###
#...#.#..G..#
#.###.#.#####
#E..#.......#
#.#.#.#.###.#
#.#...#..E#.#
#############
