11 15 2
###########
#.#.#..C..#
#.#.#.#.###
#.#...#..C#
#.###.###.#
#E#.#.#...#
#.#.#.###.#
#.#....E#.#
#.###.#.###
#...#.#...#
#.###.###.#
#...#...#.#
#.###.#####
#G.S......#
###########
