13 11 2
#############
#.#...#....C#
#.#.#.#.#.###
#...#E..#...#
#.###.#######
#.#S......#.#
#.#.#.#####.#
#.#.#.......#
#.#.###.#.#.#
#C#E#..G#.#.#
#############
