17 17 2
#################
#.....#S........#
#####.#.###.#.#.#
#.......#C#.#.#.#
#.#######.#######
#.#.#.....#.#.#.#
#.#.###.#.#.#.#.#
#...#...#...#...#
#.#########.#.###
#.#E............#
#.#.#.###.#.###.#
#...#..C#.#...#.#
#.###.#.###.#.###
#.#...#.#.#.#.#.#
#######.#.#.#.#.#
#G.....E..#.#...#
#################
