9 13 2
#########
#C...S..#
#.#######
#....E#.#
#.#.###.#
#.#.....#
#.#######
#.#.#...#
#.#.#.###
#....G.C#
###.#####
#E......#
#########
