15 9 2
###############
#...#......S.E#
###.#####.#####
#C.C#.#....G#.#
#.#.#.#####.#.#
#.#.#E......#.#
#.#.#.#.###.#.#
#.#...#.#.....#
###############
