17 17 2
#################
#.....#.........#
###.###.###.#####
#.....#.#..C....#
#.###.#.#####.#.#
#.#.....#.#...#.#
#.#.#.###.#######
#.#E#...........#
#####.###########
#.#...#.#.#.#...#
#.#.#.#.#.#.#.#.#
#.#.#C....#S..#.#
#.#.#########.###
#.....#.#..E#...#
#.###.#.###.###.#
#.#..........G..#
#################
