17 13 2
#################
#.....#..C......#
#.#.#####.#####.#
#.#.....#.#.....#
#.###.#.#.#.#.#.#
#C#...#..S#.#G#.#
#.#########.#.###
#.#.#.#E..#.#...#
#.#.#.###.#.###.#
#...#.#.#...#.#E#
#.###.#.###.#.#.#
#...#.......#...#
#################
