11 15 2
###########
#......E.C#
###.#.###.#
#...#.#..E#
#####.#.###
#C..#.#.#.#
#.#.###.#.#
#.#.......#
#.#.#.#####
#.#G#...#.#
#.#####.#.#
#.#.#.....#
#.#.#.###.#
#S..#.#...#
###########
