15 9 2
###############
#E#...#G#..C..#
#.#.#.#.###.###
#...#.#E......#
#####.###.#.#.#
#........S#.#.#
#.#.###.#.###.#
#.#C#...#.#...#
###############
