15 17 2
###############
#.......#.....#
#.#########.###
#.#.#.#.....#.#
#.#.#.#.###.#.#
#......C..#...#
#.#######.#.#.#
#E#.......#.#.#
#####.#.#.#####
#G#.#.#.#.#.#.#
#.#.###.#.#.#.#
#.#S#E#.#.#...#
#.#.#.#.#.#.#.#
#.......#C#.#.#
###.#####.###.#
#.....#.......#
###############
