11 9 2
###########
#.#...#..E#
#.#.###.###
#E.C..#...#
#.###.#.#.#
#S#.....#.#
###.#.#.#.#
#...#.#G#C#
###########
