17 15 2
#################
#.#...#...#.#.#C#
#.###.#.###.#.#.#
#.#.....#.#..E..#
#.###.###.#.#####
#.#........S#...#
#.#.###.###.###.#
#.....#.#.#.....#
###.###.#.#####.#
#.#C#.........#.#
#.###.###.###.###
#...#E#...#.#...#
###.#.#.#.#.#.#.#
#.....#.#.#...#G#
#################
