15 13 1
###############
#...#..E......#
#.#.#.#####.###
#.#.#.#...#...#
#.###.#.#.#.#.#
#...#...#.#.#.#
###.#.#####.###
#.....#.#.#G..#
###.###.#.#####
#......S#...#.#
#.###.###.#.#.#
#E..#....C#...#
###############
