9 17 2
#########
#E#.....#
#.#####.#
#.#.....#
#.#####.#
#.......#
#.#.#.###
#.#E#..G#
#####.###
#.......#
#######.#
#C...C#.#
#####.#.#
#.....#.#
#.###.#.#
#...#S..#
#########
