11 9 2
###########
#.#C....#.#
#.#.#.###.#
#G.E#..E..#
#.#######.#
#...#..C#.#
#.###.###.#
#S......#.#
###########
