11 13 1
###########
#E#..S....#
#.#.#.#.###
#...#.#...#
#######.###
#.#..E#...#
#.###.###.#
#.#.......#
#.###.#.###
#..G..#.#.#
###.#.#.#.#
#...#.#C..#
###########
