9 17 2
#########
#C.E..#.#
###.###.#
#...#.#.#
#.#.#.#.#
#.#...#.#
###.###.#
#...#.#.#
###.#.#.#
#C...S..#
###.###.#
#...#G#E#
#.#.#.###
#.#.#...#
#.###.###
#.......#
#########
