11 15 2
###########
#.#C..#.#.#
#.#.###.#.#
#..E..#.#.#
#.#.#.#.#.#
#.#.#G#...#
#.###.#.#.#
#C#.....#.#
#######.###
#........S#
#######.#.#
#.....#E#.#
###.###.#.#
#.......#.#
###########
