9 17 2
#########
#....C#C#
#####.#.#
#S#.....#
#.#####.#
#.#..E..#
#.###.#.#
#.#...#.#
#.#.#####
#.#..G.E#
#.###.#.#
#.....#.#
#.#.#.###
#.#.#.#.#
#####.#.#
#.......#
#########
