15 13 2
###############
#...#.......#.#
#.###.#######.#
#E.E....#.....#
#####.###.#.#.#
#.....#G.C#.#.#
#####.#.#.###.#
#.#.#.#.#S#.#.#
#.#.#.#.#.#.###
#.#.....#.....#
#.###.#####.#.#
#....C..#...#.#
###############
