15 9 2
###############
#G#.#.#S#.#...#
#.#.#.#.#.###.#
#.#.#...#.....#
#.#.#.#.#.###.#
#E..#E#.....#.#
#.#.###.#.###.#
#.#C....#.#..C#
###############
