15 9 2
###############
#...#...#.#...#
#.#####.#.#.###
#.#.#...#.....#
#.#.###.#####.#
#C...E..#..S..#
###.###.###.###
#C.E..#..G....#
###############
