11 9 2
###########
#C#.#.....#
#.#.#.#.###
#.....#...#
#.###.#.#.#
#E..#G#S#E#
#.#.#.#####
#C#.#.....#
###########
