17 11 2
#################
#...#.......#.#.#
#.#.#.#######.#.#
#.#...#C..#.....#
###.#.###.###.#.#
#...#G......#C#.#
#.###.#####.#.#.#
#S.E#.#.#.#.#.#.#
#.#####.#.#.###.#
#....E#.........#
#################
