15 11 2
###############
#.#...#.....#.#
#.###.#.#.#.#.#
#.......#.#...#
#.###.#####.###
#...#C...E#...#
###.#.#######.#
#...#...#.#.#E#
###.#.#.#.#.#.#
#C..#S#G..#...#
###############
