11 13 1
###########
#C......#.#
#.#####.#.#
#S#.......#
#.#####.###
#.#.#.#...#
###.#.###.#
#G........#
#######.###
#........E#
#.#.###.###
#.#..E#...#
###########
