15 17 2
###############
#...#..S.E..#.#
###.#####.###.#
#..G..#.......#
###.#.#####.###
#.#.#.#.#.#.#.#
#.#.#.#.#.#.#.#
#...#.#...#...#
#.#####.#.###.#
#.#C#...#.#...#
#.#.###.###.#.#
#.......#.#C#.#
#######.#.###.#
#.....#.#.....#
#.###.#.#####.#
#...#..E......#
###############
