9 15 2
#########
#.#.#E..#
#.#.###.#
#...#.#.#
###.#.#.#
#C#.....#
#.#.###.#
#.#.#...#
#.#.#.#.#
#S.C#E#G#
#.#.#####
#.#.....#
#.#.#####
#.#.....#
#########
