13 17 2
#############
#.......#...#
#.#####.#.#.#
#...#S...E#.#
#######.###.#
#.#.....#...#
#.#####.###.#
#...#E..#C..#
#.#########.#
#.#.........#
#.#.#########
#...........#
###########.#
#.#......C#.#
#.#.###.###.#
#..G..#.....#
#############
