13 9 2
#############
#...#.#....S#
#.###.###.#.#
#.#..C..#.#.#
#.#.#.#####.#
#...#.#.#.#G#
#.#.#.#.#.#.#
#.#E#E.....C#
#############
