13 19 2
#############
#.#.#..S....#
#.#.#.#######
#E......#.#.#
#####.#.#.#.#
#.....#E#C#.#
###.#.###.#.#
#...#.#.#.#.#
#.###.#.#.#.#
#.#.#...#...#
###.###.#.#.#
#..G........#
#.#####.#####
#.#....C....#
#####.#####.#
#.....#...#.#
#.#.#####.#.#
#.#...#.....#
#############
