15 17 2
###############
#.#S....#.#C..#
#.#.#.###.###.#
#...#.#...#..E#
###.###.###.#.#
#.....#.....#.#
###.#####.#.#.#
#.#G#...#.#.#.#
#.#.###.#.#.###
#.......#.#...#
#.###.#.#####.#
#.#...#.......#
#.#.#######.###
#..E#.........#
#.#######.###.#
#....C#...#...#
###############
