13 19 2
#############
#.#.....#...#
#.#.#######.#
#...#.....#.#
#.#.#####.#.#
#.#E......#.#
#.#.#.###.#.#
#G#..S.E#.#.#
#########.#.#
#.....#..C.C#
#####.#.###.#
#.#.#...#...#
#.#.#.###.#.#
#.#...#...#.#
#.#.###.#####
#.#.#.......#
#.#.#######.#
#.......#...#
#############
