19 13 2
###################
#..S..#.#.........#
#.#.#.#.#.###.#####
#...#..E..#.#.....#
#.#####.###.###.###
#...#.#.#C...C..#.#
#.###.#.###.###.#.#
#.....#.#.....#...#
###.###.###.###.#.#
#.....#.#..G..#.#E#
###.#####.#.#####.#
#...#.....#.....#.#
###################
