17 13 2
#################
#.........#.....#
###.#####.###.###
#...#.#.......#G#
###.#.#.#.###.#.#
#...#...#E#S....#
#####.#.###.#.###
#.....#...#.#...#
#.#########.#.###
#.....#..C..#...#
#.#.###.#.#.#.###
#.#.#....C#.#..E#
#################
