19 13 2
###################
#.#E#.....#.....#.#
#.#.#####.#.#.###.#
#.#.#....E..#..G..#
#.#.#.###.#####.###
#.......#.#.....#.#
#.#######.#####.#.#
#.#..C......#C....#
#.###.#####.#####.#
#...#.#.....#.....#
#.#######.#.#####.#
#.......#S#.......#
###################
