19 15 2
###################
#.#...#C..#.......#
#.###.###.#.###.#.#
#..S........#...#.#
#.#####.#.#.#.###.#
#.#...#.#.#.#...#.#
#.#.#.#####.#.#.###
#.#G#..C....#.#.#.#
#.#.#.###.###.###.#
#.#.#...#.........#
#.#.#.#######.###.#
#.#.#.....#..E#...#
#.###.###.###.#####
#E#...#...#.......#
###################
