15 17 2
###############
#.#S#...#.#...#
#.#.#.#.#.###.#
#.#...#.......#
#.#.###.#.#.#.#
#.#...#.#.#.#.#
#.#.#.#######.#
#...#.#E..#.#.#
###.###.#.#.###
#...#.#C#.....#
###.#.#.###.###
#..C#....E#...#
#.#.#.#######.#
#G#.#...#.....#
#.#######.#.#.#
#...........#.#
###############
