17 15 2
#################
#.....#...#.#.#.#
#.#.#####.#.#.#.#
#.#.......#...#.#
###.###.#.#.###.#
#...#...#..E....#
#.###########.#.#
#..C#......E..#.#
###.#.#######.###
#S#.#.#.#..C....#
#.#####.#.#######
#.......#...#...#
#.###.#.#.#.###.#
#..G..#...#.....#
#################
