13 13 2
#############
#E.....C....#
#####.###.###
#.#...#...#.#
#.#.###.###.#
#.#.#.......#
#.#.#.#.###.#
#.....#G#.#.#
#####.###.#.#
#S..#E#...#.#
###.#.#.#.#.#
#.....#.#C..#
#############
