19 15 2
###################
#.........#.......#
#######.#########.#
#.......#.........#
#####.#.#####.###.#
#.#.#E#.#.#E..#.#.#
#.#.#.#.#.#.#.#.#.#
#...#.#G....#..C#.#
###.#####.###.#####
#C........#.....#.#
#.#####.###.###.#.#
#..S..#.....#.#.#.#
#####.#.###.#.#.#.#
#.....#...#.#.....#
###################
