19 13 2
###################
#C......#.........#
#####.#######.###.#
#..S.......G..#...#
#.#######.#####.#.#
#E..#.........#...#
###.#.###.#####.###
#.#.#...#...#.#...#
#.#.#.#.#####.###.#
#.#.#.#..E#.....#.#
#.#.###.###.#.###.#
#.....#.#C..#.....#
###################
