17 17 2
#################
#.....#...#.....#
###.#.###.#.###.#
#.#.#.#.#C....#.#
#.###.#.#.#####.#
#.......#..S..#.#
#.#####.#.#####.#
#.#...#....E#.#.#
#.#.#.#####.#.###
#...#...........#
###.#####.###.#.#
#.#E#C......#.#.#
#.#######.###.#.#
#...#...#...#.#.#
#.#.#.#####.###.#
#.#......G..#...#
#################
