17 17 2
#################
#..S#...........#
###.#.###.#.#.###
#.#...#...#.#.#.#
#.#.###.###.###.#
#.#.#.#.#.#...#.#
#.#.#.#.#.#.###.#
#...#.....#.#...#
###.#.#.#.###.###
#...#G#.#.#.....#
###.#####.#.#.###
#C..#...#.#.#E..#
###.#.###.###.###
#.....#.#...#...#
#.#.#.#.###.###.#
#E#.....#..C....#
#################
