13 13 2
#############
#C......#...#
#######.###.#
#.......#...#
#.#####.#.###
#...#.......#
#.#.###.#.#.#
#.#.#.#.#.#.#
#.###.#.#.#.#
#S...G#.#...#
###.#.#####.#
#..C#E#E....#
#############
