15 17 2
###############
#.......#...#C#
###.###.###.#.#
#E#.#...#.....#
#.###.###.###.#
#...#.#..S#...#
#.###.#.#####.#
#...........#.#
#.#####.#####.#
#...#..G....#.#
###.#.###.#.#.#
#.#E..#...#.#.#
#.#.#.#########
#...#.#.......#
#.#####.###.###
#.........#C..#
###############
