17 13 2
#################
#.....#....S...G#
###.#.#.#.#.###.#
#C..#.#.#.#.#...#
#.#.#####.#.#.#.#
#.#E..#...#C#.#.#
###.###.###.#####
#.....#.........#
#.#.###.#.#######
#.#.....#.#.#...#
#####.#####.#.###
#........E......#
#################
