17 15 2
#################
#..E....#.......#
###.#####.#.#.#.#
#.........#G#.#.#
#.#.###.#####.###
#.#.#.#.#..C#...#
#####.#.#.#.#.#.#
#C#...#.#.#.#.#.#
#.###.#.#.###.#.#
#E..#.......#.#.#
#.###.#.###.#.#.#
#.....#...#...#.#
#.#.#####.###.#.#
#.#.#.....#S..#.#
#################
