13 19 2
#############
#.#.#.......#
#.#.#.###.###
#.....#.....#
###.#.#######
#C..#.#.#...#
#####.#.###.#
#.#.....#.#.#
#.#.#####.#.#
#...#.#.#...#
#.#.#.#.#.#.#
#G#..C..#E#.#
#.###.###.#.#
#.#....E..#.#
###.#.#####.#
#...#..S....#
###.#.#.###.#
#...#.#.#...#
#############
