19 17 2
###################
#.#.#...#E........#
#.#.###.#.#####.###
#...#...#.#.#...#.#
#.#.#.###.#.#####.#
#.#....E......#.#.#
#.#.###.#####.#.#.#
#.#.#...#..S#.....#
###.###.###.###.###
#.....#.....#.....#
###.#.###.#####.#.#
#.#...#.....#.#.#.#
#.#.#######.#.###.#
#...#.#.#.....#..C#
#.###.#.###.#######
#G.....C#.........#
###################
