17 15 2
#################
#..G....#.#...#.#
#.#####.#.###.#.#
#S#...........#.#
###.#########.#.#
#...#.#.....#...#
###.#.#.#####.#.#
#.#.....#.....#.#
#.#####.###.###.#
#.#C.E......#...#
#.#.#######.###.#
#....C#.#.....#E#
#.#####.###.#.#.#
#.........#.#.#.#
#################
