15 15 2
###############
#.....#.#S....#
#.#####.#.###.#
#......G..#...#
#.#.#####.#.###
#.#E....#.....#
#.###.#######.#
#...#.#.#.....#
###.#.#.#.#####
#...#.#..C#...#
#.#######.#.###
#....C#.......#
#####.###.#####
#..E..#.......#
###############
