17 15 2
#################
#...#.#.#.......#
###.#.#.#.#.#.#.#
#.#.#C..#...#.#.#
#.#.###.#######.#
#...#E#...#E....#
#.#.#.###.###.###
#.#.....#.......#
#####.###.#.#####
#.....#...#.....#
#.#######.###.###
#..G........#C..#
#.#.#######.#.#.#
#.#...#.....#.#S#
#################
