15 13 2
###############
#.....#.#E#...#
#.###.#.#.#.#.#
#.#C.C#.#.#S#.#
#.###.#.#.#.###
#E..#...#.#...#
#.#.#.#.#.#.#.#
#.#...#.....#.#
#.#######.###.#
#...#.#.....#.#
#.#.#.###.###.#
#.#.#.....#G..#
###############
