15 15 2
###############
#.......#.#.#.#
#.###.#.#.#.#.#
#...#.#...#...#
###.###.#####.#
#.......#.#..S#
#.###.#.#.#.#.#
#...#.#.....#C#
#.#######.#.#.#
#....E#..G#.#E#
#.#.#####.###.#
#.#.#.......#.#
#.###.#####.#.#
#.#......C#.#.#
###############
