17 19 2
#################
#.#.#.#.#.....#.#
#.#.#.#.#.#.#.#.#
#.......#.#.#...#
#.#.#.#.#.#######
#.#C#.#.#.#.#...#
#.#.#####.#.###.#
#.#S..#...#...#.#
#.###.###.#.#.#.#
#...#.#.....#...#
#.#.#.#.###.#####
#.#.....#...#C..#
#.#####.#####.###
#.#.....#...#...#
#####.###.#.###.#
#G.....E#.#...#.#
#######.###.#.#.#
#..........E#...#
#################
