13 13 2
#############
#...#..E.C#.#
###.#.#####.#
#...#.#.#.#.#
###.#.#.#.#.#
#.#S........#
#.#.#####.#.#
#.#...#.#E#.#
#.#.###.###.#
#...#.#..G..#
#.#.#.#.#.#.#
#.#C....#.#.#
#############
