17 17 2
#################
#.#C....#....C..#
#.###.#.###.#.###
#.#.#.#.#...#..E#
#.#.#.###.#.#####
#...#.....#.#.#.#
###.#.#####.#.#.#
#.....#.#.#.....#
#.###.#.#.#.###.#
#...#...#...#..E#
###.###.#.#.###.#
#S..#.#.#.#...#.#
#.###.#####.#.#.#
#....G#.#...#.#.#
#.#####.###.###.#
#.......#.......#
#################
