19 19 2
###################
#.....#.....#.....#
#.#.#.###.#####.###
#.#.#.#.#...#.....#
#.###.#.#.#####.###
#.#.#....E...G....#
###.###.###########
#.#E..............#
#.#.#############.#
#..S.C#...#.......#
###.#.###.#####.#.#
#...#.......#....C#
#####.#.#.#.#.###.#
#.#...#.#.#.#...#.#
#.#.#####.#####.###
#...#.#.......#...#
#.###.#####.#####.#
#.......#.....#...#
###################
