19 15 2
###################
#...#...#.#.#..S..#
#.###.###.#.###.###
#...#...#...#.....#
#.#.###.#.#####.#.#
#...#E#....E....#.#
#.###.#.#####.#.###
#.........#.#C#...#
#.###.#.#.#.#.###.#
#.#...#.#C..#.#.#.#
###.#####.#####.#.#
#.#.#.....#...#...#
#.###.###.#.#.#.#.#
#.....#....G#.#.#.#
###################
