19 13 2
###################
#S....#....C..#..E#
#####.#.###.###.###
#.......#...#.....#
###.#.#.###.#.###.#
#...#.#...#E..#.#.#
#####.#####.###.#.#
#...#...#.#.#G..#.#
###.#.###.#.#.#.#.#
#...#.....#.#.....#
#.#####.#####.###.#
#....C....#.....#.#
###################
