19 19 2
###################
#.#.#.........#...#
#.#.#.#####.#.###.#
#.#C...C....#.#.#.#
#.#.###########.#.#
#.#.....#...#.#.#.#
#.#.#####.#.#.#.#.#
#.#.......#...#...#
#.###.###########.#
#.#...#.......#.#.#
#.#.#####.#####.#.#
#G..#.#.........#.#
#.#.#.###.#######.#
#.#E......#.#..S#.#
###.#####.#.#.###.#
#...#.#..E........#
#.#.#.###.#######.#
#.#.....#.....#...#
###################
