19 13 1
###################
#.....#.....#...#.#
###.#.#####.###.#.#
#.#.#G....#.......#
#.#.#.#########.#.#
#.#.............#E#
#.#.#######.###.###
#...#.#.......#...#
#####.#.#####.#####
#..S#...#...#.#.#.#
#.###.#.###.###.#.#
#.....#C.....E....#
###################
