15 19 2
###############
#.#.#...#.....#
#.#.###.#.#####
#.#.#.........#
#.#.#####.#.###
#..E......#..C#
#.#####.#######
#.....#.#.....#
#####.#####.#.#
#.#S........#.#
#.#.###.###.###
#...#...#...#.#
#.#.#####.###.#
#.#.....#G...E#
#.#####.#####.#
#...#.........#
###.#####.###.#
#......C#.#...#
###############
