13 15 2
#############
#....G#.#E..#
#####.#.#.#.#
#.#...#.#S#.#
#.###.#.###.#
#.#....C..#.#
#.###.#####.#
#.#.......#.#
#.###.#####.#
#....E..#.#.#
#.#####.#.#.#
#.#.........#
###.###.#####
#........C..#
#############
