19 15 2
###################
#.#......E#.......#
#.###.#####.#######
#.#...#...........#
#.#.#.###.###.###.#
#.#.#.......#.#...#
#.#.###.###.###.###
#.....#.#...#....S#
#####.#######.###.#
#..G....#.#...#.#.#
#####.###.#.###.###
#...#.#...#.#.....#
#.###.#.#.###.#####
#........E.C.C....#
###################
