13 19 2
#############
#...........#
#.#######.#.#
#...#...#.#.#
#.#.#.#.#.###
#.#...#.....#
#####.###.###
#......C#.#.#
###.###.#.#.#
#....C#.#...#
###.#.#######
#...#.#...#.#
###.###.###.#
#E..#.#.....#
#.###.###.#.#
#....S...G#.#
#.#####.###.#
#....E#...#.#
#############
