15 17 2
###############
#.#.#E#..E#.#.#
#.#.#.#.#.#.#.#
#.......#.....#
#.###.#####.###
#.#.#...#.....#
#.#.#########.#
#.#.......#G..#
#.###.###.#.###
#.#...#.......#
#######.#.#.#.#
#....C#S#.#.#.#
#.#.###.#####.#
#.#.#.....#...#
#.#.#.###.#.#.#
#.#...#...#..C#
###############
