17 19 2
#################
#.....#.#...#...#
###.###.#.###.###
#.......#.......#
###.#####.#.###.#
#E.E..#.....#...#
#.#####.###.#####
#.....#S#.......#
#.###.#.###.#.#.#
#...#...#.#.#.#.#
#.#.#####.###.###
#.#...#.#...#.#.#
#.#.#.#.###.#.#.#
#.#.#C....#.#.#.#
#.#######.#.#.#.#
#C..#.....#.#...#
###.#####.#.#.#.#
#....G#...#...#.#
#################
