13 19 2
#############
#.#S........#
#.#.#####.###
#.......#E#G#
#.#.#####.#.#
#.#.#.......#
#########.#.#
#.....#...#.#
#.#.###.#####
#.....#.#...#
#.#####.###.#
#...#.......#
#.#.#.#.#.#.#
#C#.#.#.#.#.#
#.#.#.#####.#
#.#...#E..#.#
#.###.#.###.#
#...#...#..C#
#############
