17 13 2
#################
#...#....E..#...#
#.#####.#######.#
#...#..G#..C..#.#
###.###.###.#.#.#
#.#...#.........#
#.#.###.#.#######
#.......#C..#...#
#.#####.#.###.###
#.#....E#......S#
#######.#########
#...............#
#################
