17 13 2
#################
#.........#.....#
###.#####.#.#.###
#.......#...#...#
###.#######.###.#
#..C.....G#.....#
#.###.###.#######
#.#.#E#E..#C..#.#
#.#.###.#.###.#.#
#..S#...#.......#
###.###.#######.#
#.....#...#.....#
#################
