17 13 2
#################
#.#..C..#...#...#
#.#.#####.#.#.#.#
#.........#..E#G#
#.###.#.###.#.#.#
#...#.#...#.#.#.#
###.#######.###.#
#...#E#.#...#...#
###.#.#.#.#######
#.......#.....#.#
###.###.#.###.#.#
#S....#.....#..C#
#################
