19 17 2
###################
#...#.#E......#...#
#.#.#.#####.#####.#
#.#...#.....#.#..G#
#.###.#####.#.###.#
#.#...#...#.......#
#.###.###.#.###.#.#
#...#.....#.#...#.#
#.###.#.#######.#.#
#C#.....#.......#.#
#.###########.#####
#.#.#..C#E.......S#
#.#.#.#########.#.#
#...........#...#.#
#.###.#####.#.#.#.#
#...#.....#...#.#.#
###################
