17 15 2
#################
#S..#..........C#
###.#####.#######
#.....#.#...#.#.#
#####.#.#.#.#.#.#
#C#.....#...#.#.#
#.###.###.#.#.#.#
#.#.#.....#.#...#
#.#.#######.###.#
#...#.#E#.......#
#.#.#.#.#.###.#.#
#.#.........#.#.#
#.#.###.###.#.#.#
#.#...#..E#.#G#.#
#################
