15 15 2
###############
#.....#S#...#.#
#.###.#.###.#.#
#.#.........#.#
###.###.###.#.#
#...#........E#
#########.#.###
#...#E....#.#.#
#.###.#######.#
#.............#
#.###########.#
#..C..#.......#
#.#.#####.#####
#.#G..#..C....#
###############
