13 13 2
#############
#.#.#G...S..#
#.#.#.#.###.#
#..E..#..E#.#
#.###.#######
#...#.......#
#.#####.###.#
#...#..C..#.#
#.###.#####.#
#.#C........#
###.#######.#
#.....#.....#
#############
