19 15 2
###################
#...#...#E#...#...#
#.#.###.#.###.###.#
#.#..S..#.#.......#
###.#####.###.###.#
#.#...#C......#G#.#
#.#.###.#######.###
#.#E....#.........#
#.#.#######.#######
#.#.#...#.#...#...#
#.#.#.#.#.#.#.#.#.#
#.#...#.........#.#
#.###.#.#.###.###.#
#.....#.#.#.....#C#
###################
