15 13 1
###############
#.#G..........#
#.#.###########
#....S....#...#
#.#.###.#.###.#
#.#.#...#.#E#C#
#####.#.###.#.#
#...#.#.....#.#
#.#####.#.###.#
#.#.....#.....#
#.#.#.#.#####.#
#...#...#E....#
###############
