15 13 2
###############
#....S.E.C#...#
#####.#####.#.#
#.....#...#.#.#
###.#.#.#####.#
#...#.....#...#
###.###.#####.#
#....E......#C#
#####.###.###.#
#.#G..#.#.....#
#.#.###.#####.#
#.....#.......#
###############
