13 15 2
#############
#G..#...#.#.#
#.#.#.#.#.#.#
#.#...#.#...#
#.###.###.#.#
#.#.#....C#.#
###.#.#.#.#.#
#....E#.#.#.#
###.###.#####
#...#.....#.#
###.###.#.#.#
#.....#S#...#
#.#.#.#.###.#
#...#.#C..#E#
#############
