13 17 2
#############
#.#...#.#E#.#
#.#.###.#.#.#
#C..#...#C#.#
#.#.#.#.#.#.#
#.#...#...#.#
###.###.#.#.#
#E..#.#.#...#
#.###.###.#.#
#.#.......#.#
###.#######.#
#...#.....#.#
#.#.#####.#.#
#.#G#...#.#S#
#.###.###.#.#
#...........#
#############
