17 19 2
#################
#...........#...#
###.###.###.###.#
#.....#...#..E..#
#######.#.#.###.#
#...#...#.#.#E..#
###.#####.#.#.###
#.....#.#.#.#.#C#
#.#.###.#.#.#.#.#
#.#.........#.#.#
#.#########.###.#
#...#..G#.......#
#.#####.###.###.#
#..C#.#.#....S#.#
#####.#.###.#####
#.....#.....#...#
###.#.#####.###.#
#...#...........#
#################
