17 17 2
#################
#.........#E....#
#########.#####.#
#.......#.....#.#
###.#.#.#.###.#.#
#.#.#.#...#.....#
#.#.#.###.###.###
#...#.#G..#...#.#
#.###########.#.#
#...#S..#.......#
#.#####.#.###.#.#
#C......#.....#.#
#.#####.#.#######
#E..#...#.#.....#
###.#.###.#.###.#
#...#...#....C#.#
#################
