13 19 2
#############
#...........#
#.###.#.#####
#.#E..#.....#
###.#.#.#####
#G#E#.#.#...#
#.#####.#.#.#
#........C..#
#####.#####.#
#.....#.....#
#.###.#####.#
#.#S..#C....#
###.###.###.#
#.....#.#...#
#.#.#######.#
#.#.......#.#
###.#######.#
#.........#.#
#############
