17 19 2
#################
#.............#.#
###.###########.#
#.#.......#.....#
#.###.#######.###
#.....#...#.#...#
#.###.#.###.###.#
#...#...........#
#####.#####.#.#.#
#S....#.#...#.#.#
#.#.#.#.###.###.#
#.#.....#.....#.#
###########.#####
#..C....#.......#
#.###.###.#######
#.#G.....E......#
#.#.#.#.#.#####.#
#.#.#.#C#.#....E#
#################
