19 13 2
###################
#C..#.#...#...#.#.#
#.###.###.#.###.#.#
#..E..#...#...#..C#
#.#####.###.###.###
#..E.S....#...#...#
#.#.#.###.#.#####.#
#...#.#...#..G....#
###.#####.#.#####.#
#...#...#.#...#...#
#.###.###.#.###.#.#
#.....#.......#.#.#
###################
