15 15 2
###############
#.......#....C#
###.###.#.#.###
#.#G#....E#...#
#.#.###.#######
#S#...#.......#
#.#####.#######
#...#.........#
#.###.#.#.#####
#.#C#E#...#...#
#.#.#####.#.###
#...........#.#
#.#.#.#.#####.#
#.#.#.#.......#
###############
