13 17 2
#############
#.#G..#...#.#
#.#.#####.#.#
#C...E..#...#
#.#########.#
#.#.#.......#
#.#.###.#####
#.......#...#
###.#.#.#.#.#
#...#.#.#..S#
#.#.#.#####.#
#.#.#E....#.#
###.###.#.#.#
#C#...#.#.#.#
#.#.#.#####.#
#...#.......#
#############
