15 13 2
###############
#....C#.#...#.#
#####.#.#.###.#
#..E#....C#.#G#
#.###.###.#.#.#
#.#.#.#S...E#.#
#.#.###.###.#.#
#.........#...#
#.#.#.#########
#...#.......#.#
#.#.#######.#.#
#.#.#.........#
###############
