19 13 2
###################
#...........#.....#
###.###.#.#.###.###
#.....#.#E#.#.....#
###.###.###.#.#.#.#
#........S#C..#.#G#
#.#####.###########
#.....#.........#.#
###############.#.#
#.........#.......#
#.#.#.###.###.#.###
#C#.#...#....E#...#
###################
