13 17 2
#############
#.#.#...#...#
#.#.###.#.#.#
#G......#E#.#
#.#####.#.###
#.#.......#.#
###.###.#.#.#
#...#.#C#.#.#
###.#.#.###.#
#.#...#..C#.#
#.###.###.#.#
#.#...#.#...#
#.###.#.#.###
#E..#...#...#
#.#.###.#.#.#
#.#S......#.#
#############
