13 17 2
#############
#.#...#.#...#
#.###.#.#.###
#.#E........#
#.#.#######.#
#.#.....#.#.#
#.#.#.#.#.#.#
#...#.#...#.#
#.#.#.###.#.#
#.#.#...#.#.#
###.#######.#
#...#G#.#...#
#.#.#.#.###.#
#.#..C.....S#
#.###.#######
#E..#C......#
#############
