13 15 2
#############
#.......#E.G#
#.#######.#.#
#.........#.#
#.#########.#
#....C#...#.#
#####.###.###
#.#S.E.C....#
#.#####.#.###
#.#.......#.#
#.#.#.#.###.#
#...#.#...#.#
#.#####.###.#
#.#.........#
#############
