19 19 2
###################
#.....#.#.#.......#
#.###.#.#.###.#.###
#.#C....#.#.......#
#####.###.#.###.###
#.#.#........E#...#
#.#.#.#####.###.###
#.....#.....#....S#
###########.#.###.#
#.#.#.......#...#G#
#.#.#.#############
#...#.......#.#.#E#
###.#####.#.#.#.#.#
#.....#...#...#C..#
#.###.###.#####.#.#
#.#.........#...#.#
###.#######.#.###.#
#.......#.......#.#
###################
