19 13 2
###################
#.#.....#.#...#C#.#
#.###.#.#.###.#.#.#
#.#.#.#.#.....#.#.#
#.#.#.#.#.#.###.#.#
#....E#.#.#...#S..#
#.###.###.###.###.#
#...#..C#.#.......#
###.#####.###.#.###
#......G....#.#.#.#
#.###.###.###.###.#
#E#.....#.........#
###################
