15 19 2
###############
#.........#...#
#.#.#######.#.#
#.......#...#.#
###.#######.###
#.....#.......#
###.#.#.#####.#
#...#.#E#..C#.#
#.#####.#.#.###
#.#.#..G#.#...#
#.#.###.#.#####
#.#...#...#.#.#
#.#.###.###.#.#
#.....#..E#...#
#.#######.#.###
#.#...#.....#S#
#.###.#.#####.#
#......C......#
###############
