15 17 2
###############
#...#...#.#C..#
###.###.#.###.#
#...#.......#E#
#.#######.#.#.#
#..E#.#...#...#
###.#.#.#####.#
#..G....#S....#
###.#.###.###.#
#...#...#.#...#
###.###.#######
#.....#.#.....#
#.#.#.###.#####
#.#.#.#.#.#...#
#.###.#.#.#.#.#
#...#....C....#
###############
