15 13 2
###############
#.......#...#.#
#.#####.###.#.#
#............E#
#.#######.###.#
#...#.....#.#.#
#####.#.#.#.###
#.....#.#.#C..#
#####.###.#.###
#G.E#...#C....#
###.#.#########
#............S#
###############
