13 13 2
#############
#..C.E#.....#
#.#####.#.###
#E....#.#.#.#
#.###.###.#.#
#.#.........#
###.#.###.#.#
#..S#.#.#.#.#
###.#.#.###.#
#...#......G#
###.#.#####.#
#...#.#C....#
#############
