17 13 2
#################
#..S#...#.......#
###.#.#####.#.###
#...#.#.....#..G#
###.#.#.#####.###
#...#.#C..#.....#
###.#.#.###.#.###
#...#C....#...#E#
###.#####.#.#.#.#
#.....#...#.#...#
#####.#.#######.#
#.........#E....#
#################
