13 19 2
#############
#.#.#...#..E#
#.#.#.###.###
#S#...#....E#
#.#.#######.#
#...#.......#
#.#.#.#.#.###
#.#G#.#.#...#
#.#.#.#.#####
#.#.#.#.....#
###.#####.###
#.....#.....#
#.#.###.#.###
#.#.....#...#
#.###.#.#.#.#
#C..#.#.#..C#
#.###.#####.#
#...#...#...#
#############
