19 15 2
###################
#G#...#.........#.#
#.#.#.#.#.#.#.#.#.#
#.#.#...#.#.#.#.#.#
#.#########.#####.#
#.#.#.#..E#.......#
#.#.#.###.###.###.#
#..C...C.S#.....#.#
#.###.###.#.#####.#
#.#.#...#.#.#...#E#
#.#.#.#.#.#.#.#####
#.#...#.#.........#
###.#.#.#.#####.#.#
#...#.#.#.......#.#
###################
