17 19 2
#################
#.#...#...#.#...#
#.#.#.###.#.#.#.#
#...#.#S.....C#.#
#####.#.#.#######
#...#.#.#..G..#.#
###.#.###.#####.#
#.....#.#...#.#.#
###.#.#.#.###.#.#
#..E#.#..E......#
###.#.#.###.#####
#.#.#.#...#.....#
#.#.#########.#.#
#.#.......#...#.#
#.#.#####.###.###
#...#...#.#.....#
#.#.#.#.#.###.###
#C#.....#.......#
#################
