15 17 2
###############
#.#...#.......#
#.#.###.###.###
#.....#.#...#.#
#.#.###.###.#.#
#.#.#.#...#...#
#.#.#.#.###.###
#C#.......#...#
#.###.#####.#.#
#..C#.#.#...#.#
###.###.#.#.###
#..G......#.#E#
#.#######.#.#.#
#.......#.#...#
#.#.###.###.#.#
#S#.#...#E..#.#
###############
