15 15 2
###############
#....E..#C....#
###.###.#####.#
#E..#..G..#...#
###.#####.###.#
#.#S#.........#
#.#.#####.#.#.#
#.#.....#...#.#
#.#.#####.#####
#...#...#...#.#
###.###.#.###.#
#.#.#.#C......#
#.#.#.###.#.###
#...#.....#...#
###############
