13 19 2
#############
#..........C#
###.#.#.#.###
#...#E#.#.#.#
#.#.#####.#.#
#.#...#.....#
#.#.###.#####
#.#..G..#...#
###.###.###.#
#.#C#.#.....#
#.###.#.#####
#....S..#.#.#
#######.#.#.#
#.......#...#
#.#####.#.#.#
#.#.....#E#.#
###.#.#.###.#
#...#.#.....#
#############
