15 13 2
###############
#.#.......#..C#
#.#######.###.#
#E..#...#.#...#
#.###.###.#.#.#
#.....#.#...#.#
#.#####.#.#.###
#.....#S#.....#
#.#####.###.###
#G.C#.........#
#.#####.###.#.#
#E......#...#.#
###############
