13 19 2
#############
#G......#...#
###.###.#.#.#
#...#.....#.#
#####.###.###
#.#...#.....#
#.#####.#.###
#..E....#..S#
###.#####.#.#
#...#.#..C#.#
#####.###.#.#
#...#...#.#.#
#.#.#.###.###
#.#.........#
#.###.#.#.#.#
#.#.#.#.#.#.#
#.#.#.###.###
#....E..#..C#
#############
