15 13 2
###############
#...#.#.....#.#
#.#.#.#.#####.#
#.#...#.#.....#
###.#.#.#####.#
#...#.....#..S#
#.###.###.#.#.#
#.....#.....#.#
###.#.###.#.#.#
#.#.#.#..E#.#.#
#.###.#.#.###.#
#.....#G#C#C.E#
###############
