13 17 2
#############
#...#.#..E..#
#.###.#.#.#.#
#.#.....#.#.#
#.#######.###
#....C......#
###.###.#.#.#
#.#.#.#.#...#
#.#.#.#.#####
#C#.#.#.....#
#.#.#.#.###.#
#...#....S#G#
#.###.#.#.###
#.#...#.#.#E#
#.#.#######.#
#.#.........#
#############
