13 19 2
#############
#.#.#...#...#
#.#.#.#####.#
#.#.......#.#
#.#.#######.#
#.....#....C#
###.###.###.#
#.#.#.#.....#
#.#.#.#####.#
#..S#......E#
#.#.#####.###
#C#...#.#E..#
#.#.#.#.#.###
#.#.#.....#.#
#.###.#.###.#
#G#...#.#...#
#####.#.###.#
#.....#.....#
#############
