17 19 2
#################
#.....#.......#.#
#####.#######.#.#
#E..#C..........#
###.#.#####.#.###
#.......#.#.#...#
#####.#.#.#####.#
#.....#...#....S#
###.#########.#.#
#...........#.#.#
#########.###.#.#
#.#.........#.#.#
#.#####.#.###.#.#
#.#..C..#.#.#.#.#
#.###.#####.#####
#....G#.........#
#.###.###.#.#####
#...#....E......#
#################
