17 15 2
#################
#.#.#.....#....E#
#.#.#.#.#.#.###.#
#.#.....#.....#.#
#.#.###.#.#####.#
#.#.#.#.#.#.....#
#.#.#.###.#.###.#
#.....#...#.#E..#
#.###############
#.....#...#.....#
###.###.###.#.###
#G....#.....#.#S#
###.#.###.#.#.#.#
#C..#.....#.#C..#
#################
