17 19 2
#################
#.#E#C.......E#.#
#.#.#.#.#.#.###.#
#.#...#.#.#.#C..#
#.#####.#####.#.#
#.............#.#
#.###.#.#.#####.#
#...#.#.#G#.#...#
#.#.#######.#.###
#.......#.#..S..#
###.###.#.#.###.#
#.#.#...#.#.#...#
#.#####.#.#####.#
#.......#.#.#...#
#.#.#.#.#.#.###.#
#.#.#.#.....#.#.#
#####.#.#.#.#.#.#
#.....#.#.#.#...#
#################
