15 19 2
###############
#...#.#..C#S..#
#.###.#.#####.#
#.......#.....#
#######.#.#.#.#
#..E......#.#.#
#.###.#.###.#.#
#E#...#...#.#.#
#.#.#.#.#######
#.#...#...#...#
###.#.#.#.#.#.#
#G#.#.#.#...#.#
#.###.#########
#.#...#.....#.#
#.###.#.###.#.#
#.#.#.#...#C..#
#.#.#.#.###.###
#.........#...#
###############
