17 19 2
#################
#...#.#.....#..E#
###.#.#####.###.#
#G..#.#.....#.#.#
#.###.#.#.#.#.#.#
#.......#.#C....#
#.#####.#.#####.#
#.#...#E#.#.....#
#####.#.#######.#
#...........#...#
#######.#.###.###
#.......#...#...#
###.###.#######.#
#...#.#.#S..#.#.#
#####.#.###.#.#.#
#.......#C..#.#.#
#.###.###.###.###
#...............#
#################
