13 13 2
#############
#G....#.#...#
#.#####.###.#
#...#S......#
#.#.###.#####
#......C..#.#
#######.###.#
#E..#....E#.#
###.#.###.#.#
#.#.....#...#
#.#.###.#####
#...#....C..#
#############
