17 17 2
#################
#...#...#.......#
###.#.#.#.###.###
#.....#.#.#.#.#.#
###.###.#.#.#.#.#
#...#...#...#...#
#.#####.#.#######
#.#.#......E..#.#
###.###.#######.#
#.....#...#.....#
#.#.#.#.###.###.#
#.#.#S........#.#
###.#########.###
#....C..#..C.G..#
#.#.#.#####.#.###
#.#.#...#..E....#
#################
