13 13 2
#############
#G..#E......#
###.###.###.#
#....S#.#C#.#
###.###.#.###
#.........#E#
###.###.#.#.#
#..C..#.#...#
#.###.#.#####
#.#...#...#.#
#.#.###.###.#
#...#.......#
#############
