17 19 2
#################
#.....#.....#...#
###.###.###.#.###
#C....#...#G....#
###.#.###.###.#.#
#...#.........#.#
#.#.###.#.#####.#
#.#.#...#...#...#
#########.#.#####
#.....#S..#.....#
#.#.#####.#####.#
#.#...........#C#
#########.#.#####
#.........#...#.#
###.#######.###.#
#.....#.#..E.E..#
#.#####.#.#####.#
#.#.......#.....#
#################
