19 17 1
###################
#.#...#.#E#.......#
#.#.###.#.#.#.###.#
#.........#.#.#...#
###.###.###.#####.#
#.....#E..#.....#.#
#.#####.###.#######
#.#.......#..G#...#
#.#.#.###.#.#####.#
#.#...#.....#.....#
#.###.#####.#####.#
#.#.#...#....S..#.#
#.#.#############.#
#.........#C......#
###.###.#.#.#####.#
#.....#.#.......#.#
###################
