15 13 2
###############
#G......#.....#
#.#####.###.#.#
#.#.#E.S#.....#
###.###.#.#####
#.#...........#
#.###.###.#.###
#...#..E#.#...#
###.#.#########
#.#C.......C..#
#.#.#.###.###.#
#...#...#...#.#
###############
