19 13 2
###################
#..C..#..C#.......#
###.###.###.#####.#
#...#...#...#.#...#
###.###.###.#.#####
#.#.....#..G....#.#
#.#.#.#####.#.###.#
#.......#.#.#.....#
###.###.#.#.#.#####
#....E#S#...#.....#
#.#.###.#.#####.#.#
#E#...#.....#...#.#
###################
