17 19 2
#################
#.#..C.....S..#.#
#.###.#####.###.#
#...#...#.#.#...#
#.#.###.#.#.###.#
#...#.....#.....#
###.#######.###.#
#.#...#.....#...#
#.#.###.#.#######
#.......#.#..C..#
#.#####.#####.###
#.#...#E.G......#
#.###.#.###.###.#
#...#....E#.#...#
#.#.#######.###.#
#.#.....#.#.#.#.#
#.#####.#.#.#.#.#
#...#.....#.#...#
#################
