13 17 2
#############
#...#E#..C#.#
#.#.#.###.#.#
#.#..E......#
#######.###.#
#...#.#...#.#
#.#.#.#.###.#
#.#...#...#.#
#.#.#.#####.#
#.#.#..C#...#
#.#.#.###.#.#
#S#.#...#.#.#
###.#.###.#.#
#G..#.#...#.#
#####.###.#.#
#...........#
#############
