15 15 2
###############
#.#........G..#
#.#.#####.###.#
#...#.....#.#.#
#.#.#####.#.###
#.#.#.#.#...#.#
###.#.#.###.#.#
#E.E#.......#.#
#.###########.#
#S...C#.#.#...#
#.#####.#.#.###
#...#.......#.#
#.#.#.#.#.#.#.#
#C#...#.#.....#
###############
