19 15 1
###################
#.#..S#.#...#.....#
#.#.###.#.#######.#
#.......#....G#.#.#
#######.###.#.#.#.#
#.......#...#.#...#
###.###.#.#.#####.#
#.....#..E#.....#.#
#####.###.#######.#
#C#..E..#.......#.#
#.#####.#########.#
#.................#
###.###.#.#.###.###
#.....#.#...#.....#
###################
