15 19 2
###############
#.#..C...G#E..#
#.#####.###.###
#.#.#.......#.#
#.#.###.#####.#
#...#.........#
###.#.#.#.#.###
#...#.#.#.#.#.#
#.#.###.#####.#
#.#...#.#...#.#
#.###.#.###.#.#
#...#.#.#.#.#.#
#.###.#.#.#.#.#
#.#........S#.#
#.#.###.#.#.#.#
#C#...#.#.#...#
#.###.#.#######
#.#..........E#
###############
