13 15 1
#############
#...#.......#
###.#.#######
#.....#.....#
#.###.#.#.#.#
#S..#.#.#.#.#
#.#.#.#.#####
#.#.........#
###.#.###.#.#
#E#.#.#.#G#.#
#.#.###.#####
#....C#E..#.#
###.#.###.#.#
#...#.......#
#############
