19 15 2
###################
#...#.....#...#...#
###.###.###.###.#.#
#G...C......#.#...#
#.#####.#####.###.#
#.#.......#..E.E#.#
###.###.#.###.###.#
#.....#S#.........#
###.#######.###.###
#...#...#.....#...#
#.#.###.###########
#.#C..............#
#.#.#.#####.#.#.#.#
#.#.#.....#.#.#.#.#
###################
