13 13 2
#############
#......G....#
#.#.#.#####.#
#E#.#C#.....#
###.###.#.#.#
#..C....#.#.#
###.###.#.###
#.#E#.#.#...#
#.###.###.###
#.......#...#
#.#.###.#.#.#
#.#S..#...#.#
#############
