15 19 2
###############
#...#.#.......#
###.#.#.#.#.###
#.......#.#.#.#
###.#.#.#####.#
#.....#.......#
#.#.###.#######
#.#..G#.......#
###.#.#.#######
#...#.#.#....C#
#.#.#.#.#.###.#
#.#.#.#...#...#
###.#####.#####
#...#.#.....#.#
#.#.#.###.###.#
#.#.#C#....E..#
#.#.#.###.#.###
#.#S..#E..#...#
###############
