17 13 2
#################
#.#.#...#...#...#
#.#.#.#####.#.###
#..C#C....#..S#.#
#.#.#.#.#####.#.#
#E#.#.#...#.....#
#.#.###.#.#.#.###
#.#.#.#.#...#...#
#.###.#.###.###.#
#..........G#...#
#.###.#.#####.###
#...#.#.#E......#
#################
