13 15 2
#############
#.#...#.....#
#.#.#####.###
#E....#..C.S#
#.#.###.#.###
#.#.#...#..G#
#.#.#.#####.#
#.......#...#
#.###.#####.#
#...#.#...#.#
#.#######.#.#
#.....#.#.#.#
#.###.#.#.#.#
#.#...#C...E#
#############
