19 17 2
###################
#.....#....G.E....#
#####.#.###.#######
#.#S..............#
#.###.#######.###.#
#.#...#...#.....#.#
#.###.#.#.#####.###
#..E....#.#...#C#.#
#####.#######.#.#.#
#...#.#.#.......#.#
#.###.#.#.###.###.#
#.......#...#.....#
#.#.#########.#.###
#.#...#.#..C#.#...#
#.#####.#.#.#.###.#
#.#.......#.....#.#
###################
