13 17 2
#############
#..E..#.....#
###.###.###.#
#..C#E#.#.#.#
#.###.#.#.###
#.........#.#
#####.#####.#
#.....#.#...#
###.###.#.###
#....G..#...#
#.#.#.#.#.###
#.#.#.....#C#
#.#.#.###.#.#
#.#.#.#.#...#
#.###.#.#.###
#.#...#....S#
#############
