17 19 2
#################
#.#..S........#.#
#.###.###.###.#.#
#.......#...#C..#
#####.#.###.#.#.#
#...#.#.#E#.#.#.#
###.#.###.###.#.#
#.....#.#..C...G#
###.###.###.#####
#...#.....#.#...#
#######.#.#.###.#
#.#.....#.#.#..E#
#.#.###.#.#.###.#
#.....#.#.#.....#
#.#######.###.###
#.#.............#
#.###.#####.#.###
#...#.....#.#...#
#################
