19 15 2
###################
#...........#.....#
#.###.#####.#.###.#
#...#...#.....#..C#
#.###.#########.###
#...#G......#S..#.#
#####.#####.#.###.#
#.........#...#...#
#.#####.#.#####.###
#.....#.#.#.....#.#
###.#.#.#.#.#.#.#.#
#E#.#.#.#.#.#E#..C#
#.#####.#####.###.#
#.............#...#
###################
