17 15 1
#################
#..G#.....#...#.#
#.###.#####.#.#.#
#E......#..C#...#
#####.#.#######.#
#.....#.....#.#.#
#.#.#.#.#.###.#.#
#...#.#.#..E..#.#
#######.#.#####.#
#...#...#.......#
#.#.#.#.###.#.#.#
#.#...#.#...#.#S#
#.#.###.#.#####.#
#.#...#.#.....#.#
#################
