19 19 2
###################
#....C....#..E#...#
#.###.#.###.###.#.#
#.#...#.#...#...#.#
#####.###.#######.#
#.....#.#.#.#...#C#
###.###.#.#.#.###.#
#.#....G....#...#.#
#.#.###########.#.#
#................E#
#.#.###.#.#.#####.#
#.#...#.#.#...#...#
###.###.#.#.#.#.###
#.....#...#.#.#...#
#######.#.#.#######
#.#...#.#.#.......#
#.#.###.###.#######
#S......#.........#
###################
