19 17 2
###################
#.#...#G#.#.....#.#
#.#.###.#.#.#.#.#.#
#.....#.....#.#.#.#
###.#.#.#.#.#####.#
#.#.#...#.#.#.....#
#.#####.#####.###.#
#.#.....#.......#.#
#.#.#.###.#.#####.#
#..C#.....#.#...#.#
#.#####.###.###.#.#
#.#..E..#.........#
#######.###.#####.#
#.......#C..#S..#.#
###.#######.###.###
#...#........E....#
###################
