17 15 2
#################
#...#E....#.....#
###.#.#####.#####
#.#.............#
#.#####.#.#.###.#
#..C....#.#...#.#
#########.###.###
#.#...#......G#.#
#.#.#######.#.#.#
#.....#E..#.#...#
###.###.###.###.#
#...........#...#
#.#####.#####.###
#S.C..#...#.....#
#################
