17 15 2
#################
#.#...#.........#
#.###.#.#.#.###.#
#.......#.#.#.#.#
#####.###.#.#.#.#
#.....#..C#.#...#
#.#########.#.#.#
#C....#.....#.#S#
#.#.#.###.###.###
#.#.#...#.#.....#
#.###.#.###.###.#
#G#...#.#....E#.#
#####.###.###.#.#
#....E..#...#...#
#################
