19 15 2
###################
#...#.....#.....#.#
###.###.#.#.###.#.#
#.#.#..G#E....#...#
#.#.#.#.#.#.###.#.#
#...#.#C#.#.#.#.#.#
#.#.#.###.###.#.###
#.#...#.#.....#..E#
#.#.###.#.###.#.###
#...#...#...#.#...#
#.#####.###.#####.#
#.........#.#.....#
#.#.###.#.###.#####
#.#.#C..#..S#.....#
###################
