15 13 2
###############
#S.C..#.....#.#
#.###.#####.#.#
#.........#.#.#
###.#######.#.#
#...........#.#
#.#.#.###.###.#
#.#.#...#.....#
#.###.#######.#
#.#G#.....#.#.#
#.#.#.###.#.###
#.#...#....E.C#
###############
