17 19 2
#################
#...#...#.......#
###.#.#.#####.###
#.....#.#.....#.#
###.###.#.###.#.#
#...#E..#...#...#
#.#####.###.#.###
#E...C#..G#.#...#
###.###.#####.#.#
#..S#C....#...#.#
#.#.#####.#.#####
#.#...#.....#...#
###.#####.###.#.#
#.#...#...#...#.#
#.#.###.#.###.###
#.......#...#.#.#
###.###.###.#.#.#
#.....#.#.......#
#################
