19 17 2
###################
#...#...#C..#.#...#
#.###.###.#.#.#.#.#
#.....#...#.#...#C#
#.###.#.#.###.#####
#.#.....#.#.....#.#
#.#.#####.#.###.#.#
#...#...#...#..G..#
###.#.###.###.#####
#...#.#.#.#.#.#...#
#####.#.#.#.###.###
#...#............S#
#.#.#.#####.#.#.###
#.#.#.#...#.#.#E..#
#.#####.#.#.#.#.#.#
#....E..#...#.#.#.#
###################
