13 19 2
#############
#...#..S#.#.#
#.###.###.#.#
#.#.#.#.#...#
#.#.#.#.###.#
#...........#
#.#.#######.#
#.#...#.....#
###.#.###.###
#E..#.#.#...#
#.#.#.#.#####
#.#.#C#.#.#.#
###.#.#.#.#.#
#...#.......#
#.#####.###.#
#...#C....#.#
###.###.#.###
#....G..#E..#
#############
