17 19 2
#################
#...#E#...#.#...#
###.#.#.###.#.###
#.#.........#...#
#.###.#####.###.#
#...#...#C.....C#
#.###.#.###.###.#
#..G..#.#.#..E#.#
#.#######.#####.#
#.........#.....#
#####.###.#.###.#
#...#.#.....#.#.#
#.#.#.#####.#.###
#.#.#.#.#.....#.#
###.#.#.#.#####.#
#.......#.#.....#
#####.#.#.###.#.#
#.....#.#S....#.#
#################
