15 17 2
###############
#...#.....#G..#
#.#.#.#.#.#.###
#.#.#...#.....#
#.###.#####.#.#
#....C..#.#.#.#
#.###.###.###.#
#...#.#.#.#...#
#####.#.#.#.#.#
#....S....#E#.#
#.#########.###
#.....#E#...#.#
#####.#.#####.#
#C..#.#.....#.#
###.#.#.###.#.#
#.......#.....#
###############
