19 17 2
###################
#.....#.#.......#.#
#.###.#.#.###.###.#
#.#.....#...#C..#.#
#.#####.#.#.###.#.#
#.........#...#...#
#.###.#####.#.#.#.#
#...#.....#.#.#.#.#
#.#.###.###.#####.#
#.#.#....G#E..#.#.#
###.###.#######.###
#..C#.....#.......#
#####.#.#.#.#####.#
#.#...#.#..S....#.#
#.###.#########.###
#........E..#.....#
###################
