15 19 2
###############
#.#.....#..C..#
#.###.###.#####
#...#..G......#
###.#.#######.#
#.#.#E..#...#.#
#.#.#.###.#.#.#
#E......#.#.#.#
###.###.#.###.#
#...#.#...#S..#
#.#.#.#.###.###
#.#.#.#...#.#C#
#.###.#####.#.#
#.....#.#.....#
###.#.#.#.#.#.#
#...#.#...#.#.#
#.###.#.#.#.###
#.#.....#.#...#
###############
