15 13 2
###############
#...#...#.....#
#.#.#.#.###.###
#.....#.....#.#
#########.#.#.#
#E....#...#.#.#
###.###.#####.#
#.....#.#.#.#.#
#####.#.#.#.#.#
#S....#C#C....#
#.#.#.#.###.#.#
#.#.#E.G....#.#
###############
