19 13 2
###################
#.#.#.....#E..#.#.#
#.#.###.#.#.#.#.#.#
#...#.#.#.#G#.#...#
#.###.###.#.#.#.#.#
#S#.......#.....#.#
#.#.#.###.#.#######
#...#.#.#...#.....#
#######.###.###.###
#E#.#.#C........#.#
#.#.#.###.#####.#.#
#.........#C......#
###################
