19 13 2
###################
#.....#.#C......#.#
###.#.#.#.#.#####.#
#G..#.#.#.#.......#
###.###.###.#.###.#
#...........#...#.#
#####.#.#######.###
#...#.#E..#....C..#
###.#####.#######.#
#S..............#.#
#.#.###.###.#.#####
#.#.....#..E#.....#
###################
