13 13 2
#############
#.#.#..C#..G#
#.#.#.###.#.#
#.#.#.#.#.#.#
#.#.#.#.#.###
#.......#.#E#
#.#######.#.#
#....C......#
#####.###.###
#..E..#...#.#
#.#.###.#.#.#
#.#.....#..S#
#############
