19 17 2
###################
#..C..#.#.....#.#.#
###.###.#.###.#.#.#
#S.....E#C#.#...#E#
#.#####.#.#.###.#.#
#.....#.#.#...#...#
###.###.#.#.#.#.###
#...#.......#.#...#
###.#####.#.###.###
#...#.....#.#.....#
#.###.#####.#####.#
#.#.#.....#.#G..#.#
###.#.#.#.#.#.###.#
#.....#.#.#.#...#.#
#.#.#.#######.#.#.#
#.#.......#...#...#
###################
