19 13 2
###################
#.#.#..C#...#.#..E#
#.#.#.#.#.###.#.###
#...#.....#S......#
#.###.#######.#.###
#.#..E..#.#..G#...#
#.#.#####.###.#.###
#...#.....#...#...#
###.#.#.###.#####.#
#.....#.#.#.....#.#
#.#.###.#.#####.###
#.#...#....C......#
###################
