13 15 2
#############
#....C#.....#
#.#.###.###.#
#.#...#...#E#
#.#.###.#####
#.#.#.......#
###.#.###.###
#...#...#...#
###.#.###.###
#...#...#.#.#
#.###.#.#.#.#
#E.C..#.....#
#######.#####
#G.....S....#
#############
