19 17 2
###################
#E#...#...#.......#
#.###.###.#.#.#####
#..S..#.....#.....#
#.###.###.#######.#
#.#.....#.#..G#...#
#.###.#.#.#.#####.#
#...#.#.#.#.....#.#
###.###.#.#.###.#.#
#E....#...#.......#
#.###.###.#######.#
#.#C....#...#.....#
#.###############.#
#C#...............#
#####.###.#####.#.#
#.......#...#...#.#
###################
