15 13 2
###############
#.#..........C#
#.#.#####.#####
#S............#
#.#.###.#######
#E#.#.....#...#
###.#####.#.#.#
#..C#..E#...#.#
#.###.#.#.#.#.#
#....G#.#.#.#.#
#.#########.#.#
#.........#.#.#
###############
