19 15 2
###################
#..E#...#.....#...#
#.###.#.###.###.###
#.......#..E..#.#.#
###.#####.###.#.#.#
#G..#.#...#.#...#.#
#.###.#.#.#.#####.#
#.#.....#.#.#.#.#.#
#.#.#.#.#.#.#.#.#.#
#...#.#.#C........#
#.#.###############
#.#...#S..#.......#
#.###.#.#.#.#.#.#.#
#C..#...#...#.#.#.#
###################
