15 15 2
###############
#..G#..C......#
#.#.###.#.#####
#.#...#.#.....#
#####.#.#######
#....S#.......#
#.#####.###.###
#........E#.#.#
#.#.#######.#.#
#.#...#.#..C#.#
#######.###.#.#
#E#.......#...#
#.#.#####.#.#.#
#...#.........#
###############
