13 13 2
#############
#...#......C#
#.#.#.#.#####
#S....#.#C..#
#.###.###.#.#
#.#.#.....#.#
###.#.#.#.###
#...#.#.#E.G#
#.#####.###.#
#.#.....#...#
#.###.#######
#....E......#
#############
