19 13 2
###################
#.........#.#.....#
#######.###.#.#####
#......G.E#E.....C#
#.#####.#.#.#.#####
#.#.#.#.#...#.....#
#.#.#.#.###.#.#####
#.#...#..S#.#..C..#
#.###.#.#########.#
#.......#.#...#.#.#
#.#.#.#.#.###.#.#.#
#.#.#.#.........#.#
###################
