17 13 2
#################
#.#.#..E#.......#
#.#.###.#.###.###
#..C..#....G#...#
###.#.#.#.#.#.#.#
#.#.#.#.#.#...#.#
#.###.#.#####.###
#.....#.#...#.#.#
#.#.#.#.#.#####.#
#.#.#.#.........#
###.#.#.#####.###
#...#C.....E#S..#
#################
