19 15 2
###################
#...........#.#...#
#.#.###.#.###.#.#.#
#.#.#C..#.......#.#
#.#.#.#.#.#####.###
#.#.#.#.#.#.#.#...#
###########.#.###.#
#.#.....#.#G..#...#
#.###.#.#.#.#.#.#.#
#..C#.#.....#...#.#
#.#.#.#####.#####.#
#...#.#.....#.#.#E#
#.#.#.#####.#.#.#.#
#.#..E#S........#.#
###################
