13 15 2
#############
#.#.#.#.....#
#.#.#.#####.#
#....C#..E#.#
###.#####.#.#
#.#.....#..E#
#.#.###.#.###
#.#...#...#.#
#.#.#.#.###.#
#...#.#S....#
###.#.#.#####
#...#...#G..#
#.###.#.#.###
#...#C#.....#
#############
