19 13 2
###################
#.......#...#G.E..#
#####.#####.#.#.###
#.#C....#...#.#...#
#.###.#####.#.#####
#.#.....#C........#
#.#.#.#.#.###.#.###
#.....#.#.#.#.#...#
###.###.#.#.#####.#
#..S..#.#.#.#E#...#
#.###.###.#.#.#.#.#
#...#.....#.....#.#
###################
