13 17 2
#############
#..E.S#...#.#
#####.###.#.#
#.#.....#...#
#.#.###.#.#.#
#.#.#.#...#.#
#.###.#.#####
#.#.........#
#.#.#######.#
#...#.......#
#.#.###.#####
#.#E........#
###.###.###.#
#.....#.#G..#
#.###.#####.#
#.#..C..#C..#
#############
