13 13 2
#############
#S#.#.....#.#
#.#.#.#.###.#
#...#.#E#...#
#.#.#.###.#.#
#.#.#C#.#C#.#
#.###.#.###.#
#...#..E..#G#
###.###.#.#.#
#.......#...#
#.#.###.###.#
#.#...#.....#
#############
