19 13 2
###################
#.........#...#E..#
#.#.#.#.#####.#.###
#.#.#.#.........#.#
#.#.#######.#.###.#
#C#G#....S#C#...#.#
#.#####.###.#.#.#.#
#.....#.....#.#...#
###.###.#####.#####
#.........#......E#
#.#.###.###.###.#.#
#.#...#...#...#.#.#
###################
