15 19 2
###############
#...#...#...#.#
#.###.#.#.###.#
#..S..#....E#.#
#####.#####.#.#
#.....#...#.#.#
#.###.#.#####.#
#.#.....#.....#
#.###.#.#.#.#.#
#.#....C..#.#.#
#.#.###.#####.#
#.#.#E..#.....#
#.#####.###.###
#...#..G..#...#
#.#######.###.#
#.#...#...#.#.#
#.###.#.###.#.#
#C#.....#.....#
###############
