15 15 2
###############
#.#...#.......#
#.###.#####.#.#
#.#.#....G#.#.#
#.#.###.#.#.#.#
#....S..#.....#
#.#.###.#####.#
#.#C#...#.#...#
#####.#.#.#####
#C#E..#.#.....#
#.#.#.###.#.###
#...#E....#.#.#
#.#.###.#.#.#.#
#.#...#.#.#...#
###############
