17 15 2
#################
#...#...#S......#
#.#####.#.#.###.#
#.....#...#.#...#
#.#.#.#######.#.#
#...#.........#.#
###.#.###.#####.#
#.#C#.#...#E....#
#.#.#.#######.###
#.#.#.....#.....#
#.#.#####.###.#.#
#C....#.#.#...#.#
###.###.###.###.#
#..E..#....G..#.#
#################
