13 19 2
#############
#.....#.....#
###.#####.###
#...#.#.#...#
#.#.#.#.###.#
#.#..S#.....#
#.###.#.#####
#..C..#.....#
#####.#.#.###
#.#.....#...#
#.###.#.#####
#.....#E..#.#
#.###.#####.#
#E#......G#C#
#.#.#.###.#.#
#.#.#...#...#
#.#########.#
#...#.......#
#############
