15 17 2
###############
#C#.......#...#
#.#.###.#.#.#.#
#.#.#.#G#.#.#.#
#.#.#.#.#.#.###
#.#...#C#.#..E#
#.###.#####.#.#
#.#.#...#...#.#
#.#.###.#####.#
#.#...#.#.....#
#.#.#.#.###.#.#
#.#.#.......#.#
#.#.#.###.#####
#.#.#.#S......#
#.#.###.#####.#
#.....#..E....#
###############
