17 15 2
#################
#..C#...........#
###.###.###.###.#
#.#G....#...#.#.#
#.###.###.#.#.###
#..S....#..C..#.#
#.#.#######.#.#.#
#.#...#.#...#...#
#####.#.#.#####.#
#.....#.#.#.....#
#.###.#.#####.#.#
#...#E#....E..#.#
#.#.###.#######.#
#.#.#...#.......#
#################
