15 13 2
###############
#E.....E......#
#.#####.###.###
#...#..C#.#...#
#.#.#####.#.#.#
#.#.....#.#.#G#
#.#.###.#.#.#.#
#.#C..#.#.#.#.#
#####.###.###.#
#.#.#.....#...#
#.#.#.#.#.#.#.#
#S....#.#...#.#
###############
