13 13 2
#############
#.#C....#E..#
#.#####.#.#.#
#.#.#G....#.#
#.#.#.#.###.#
#.....#...#.#
#####.###.###
#.....#..C..#
#.#####.#####
#.#E#.......#
#.#.#.#.###.#
#.#..S..#...#
#############
