13 17 2
#############
#...#.......#
#.#######.#.#
#..C....#.#.#
#####.###.#.#
#.#.#..G..#.#
#.#.###.#.#.#
#.........#.#
#########.###
#..E#.#.....#
###.#.#.#.#.#
#.#.....#.#.#
#.#.###.#.###
#.....#.#..S#
#.#.#######.#
#C#.#E......#
#############
