19 19 2
###################
#.#C........#.....#
#.#####.#.#.###.#.#
#.#.#...#.#....C#.#
#.#.#######.#####.#
#.#.....#.....#...#
#.#.#####.#.#.###.#
#...#.....#...#...#
###.#.###.###.#####
#.#.#.#.....#.#...#
#.#.#.#####.#.#.###
#...#...#G..#.....#
#.#.#.#.#######.###
#.#.#.#S....#..E#.#
###.#.#.#.#####.#.#
#...#.#.#...#...#.#
#.#####.###.###.#.#
#........E#.#.....#
###################
