13 15 2
#############
#....S....#.#
#######.#.#.#
#...#E..#E..#
#.#####.###.#
#...#...#G#.#
#.#.###.#.#.#
#.....#...#.#
#####.###.###
#.#...#...#.#
#.#.#.#.###.#
#...#...#.#.#
#.#####.#.#.#
#C..#....C..#
#############
