19 13 2
###################
#.#E#.......#...#.#
#.#.#######.###.#.#
#..G.......E....#.#
#.#.#.#####.#.###.#
#.#.#...#...#.#...#
#.#######.#.###.###
#...#C#...#..C....#
#.###.#.#.###.###.#
#.#.....#.#.......#
#.###.#####.#.###.#
#...#S....#.#...#.#
###################
