13 15 2
#############
#...#....S#.#
#.#.###.#.#.#
#.#.....#...#
#####.#.#.###
#.#...#E.C..#
#.#####.#####
#.#...#.#...#
#.#.#.#.###.#
#...#.......#
###.#####.#.#
#....E#C..#G#
###.#######.#
#.....#.....#
#############
