19 13 2
###################
#...#...#.#.#.....#
#.#.#.#.#.#.#.#.###
#E..#G#...#...#..C#
#.#######.#.#.#.###
#...#.......#.#...#
#.#####.###.#.#.#.#
#...#...#.#.#.#E#.#
#.#####.#.#####.###
#S..#...#..C#.....#
###.#.#####.#.#####
#.....#...........#
###################
