13 15 2
#############
#.....#.#...#
###.###.#.#.#
#.#...#...#.#
#.###.#####.#
#..E...C#...#
#.###.###.#.#
#C#.........#
#####.###.###
#.#.#...#.#.#
#.#.#.###.#.#
#E.S..#.....#
#.#.#.#.#####
#.#.#G#.....#
#############
