15 13 2
###############
#.#........S..#
#.#.#######.#.#
#...#.......#.#
#.#######.#####
#.#...#.#G....#
#.###.#.#####.#
#E.C#.....#...#
#.###.#.#.###.#
#...#C#E#.....#
#####.#.#.#.#.#
#.....#.#.#...#
###############
