15 19 2
###############
#.#.#...#S....#
#.#.###.#.#####
#.....#...#...#
###.###.#.###.#
#.#...#.#.....#
#.#.#########.#
#.#C....#.....#
#.#.#########.#
#.#.#...#.#E#G#
#.#.#.#.#.#.#.#
#...#.#.......#
#.#.###.#####.#
#.#.......#.#.#
#####.###.#.#.#
#.....#...#E..#
#.###.#####.#.#
#.#...#..C....#
###############
