19 17 2
###################
#.......#.#.#E....#
#.#.#.###.#.#.#####
#C#.#.....#.......#
#.#####.#####.###.#
#.#.....#...#.#...#
###.#.#.#.###.###.#
#...#.#.#.....#...#
#.#.#.###.#.#####.#
#.#.#.....#E#.#...#
###.###.###.#.###.#
#.#.#...#S....#...#
#.#.###.#######.#.#
#..G#C#.....#.#.#.#
###.#.#.###.#.#.#.#
#...#.....#.....#.#
###################
