19 15 2
###################
#C....#...#S#.#...#
#####.#.#.#.#.#.###
#...#...#...#.#...#
###.###.#.###.###.#
#.#...#.#.#.....#.#
#.#.#####.###.#.#.#
#...#...#.#...#...#
#.#.###.#.#.#.###.#
#.#.#.#.....#..G#.#
###.#.###.#####.###
#E.C......#.#E#.#.#
#.#.###.###.#.#.#.#
#...#.......#.....#
###################
