15 13 2
###############
#......G#.#.#.#
#######.#.#.#.#
#.....#.......#
#.#.#####.###.#
#.........#...#
#########.#.#.#
#C..#..E..#.#.#
#.#####.#######
#.......#C.S..#
#######.###.#.#
#......E....#.#
###############
