13 15 2
#############
#.#E#...#...#
#.#.###.###.#
#.......#...#
#.###.#####.#
#.......#...#
###.#.#.#.###
#...#.#...#E#
#.#####.#.#.#
#.#..S#.#...#
#.###.###.###
#.#C....#...#
#.#.#.#.#.#.#
#..G#C#.#.#.#
#############
