15 15 2
###############
#...#....G....#
###.#.#.###.#.#
#.....#.#...#C#
###.#########.#
#...#...#E....#
###.###.#####.#
#.#.#.......#C#
#.#.#######.#.#
#.#.#.......#.#
#.#.#####.###.#
#.....#.......#
###.#.#.#######
#...#......E.S#
###############
