19 13 2
###################
#.....#.#.........#
#.###.#.#.#.#######
#.#....G....#.....#
#.#####.#####.#####
#.#.#.....#..S....#
###.#####.#.###.###
#...#.......#.....#
#.#.###.#########.#
#.#..E.C..#....C..#
###.#.###.#####.#.#
#..E#.#...#.....#.#
###################
