15 19 2
###############
#.#.....#...#.#
#.###.#####.#.#
#...#.....#E..#
###.###.#.###.#
#.......#...#.#
#.###.#####.#.#
#.#.....#....C#
#.#.#.#######.#
#.#.#.....#.#.#
#####.#####.#.#
#.....#.......#
###.#.#.#.#.###
#E..#.#.#.#..S#
#.###.#####.#.#
#G#.....#C..#.#
#.###.#.###.###
#.#.......#...#
###############
