19 19 2
###################
#.#...#.#.....#C..#
#.#.###.#.#.#.#.###
#...#...#.#.#.....#
#.#.#.###.#########
#.#.#.....#.......#
#.#.###.#.#####.#.#
#.#.#...#.......#.#
###.#######.###.#.#
#......G......#.#.#
###.#.#.#######.#.#
#.#.#.#.....#.#.#.#
#.#####.###.#.#.###
#.#.......#.#E...C#
#.#########.#####.#
#S..#.......#.#.#.#
#.#.#.###.#.#.#.#.#
#.#E..#.........#.#
###################
