19 17 2
###################
#...#...#...#C.E#.#
###.#.#.#.#.###.#.#
#...#.#.#.#.#.....#
#.###.#.#.#######.#
#.....#....C....#.#
#.#.###.#########.#
#.#.#.#...........#
#.#.#.###.###.#.#.#
#.#.....#G#...#.#.#
#.###.###.#####.###
#...#.#.#....E#...#
#.###.#.###.###.###
#...#.......#.#...#
#.#######.###.#.#.#
#S....#...#.....#.#
###################
