19 17 2
###################
#..E#...#.#.#.#...#
###.#.###.#.#.#.###
#.....#..........S#
###.#####.#########
#.#..........G..#.#
#.#####.#######.#.#
#.......#.#.......#
###.###.#.#########
#.#.#C#...........#
#.#.#.#####.#######
#...#.#..C#.....#.#
#.###.#.#.#.#.###.#
#...#...#.#.#....E#
#.#.#.#.#.###.###.#
#.#...#.#.......#.#
###################
