13 19 2
#############
#.#......C..#
#.###.###.###
#.#.#..E#...#
#.#.#######.#
#.#.........#
#.###.#.#.#.#
#.#.#.#.#.#.#
#.#.###.#####
#...........#
#.#.#####.###
#.#...#..S..#
#.#.#####.###
#.......#G..#
#.#######.###
#.#.#.#..C..#
#.#.#.#.###.#
#.#......E#.#
#############
