17 19 2
#################
#.#..S#...#.....#
#.###.#.#####.#.#
#...#.......#.#.#
#.#######.###.###
#..E..#C....#...#
#.###.###.#.#.#.#
#...#.....#...#G#
###.#######.#####
#........E#...#.#
#.#.#######.#.#.#
#.#.#...#..C#...#
#.#.#.#####.#####
#.#.....#.......#
###.###.#.#.###.#
#...#...#.#.#...#
#######.#.#.###.#
#.........#.#...#
#################
