15 15 2
###############
#...#.....#.#C#
#.###.#.#.#.#.#
#.....#E....#.#
#.#.#.#.###.#.#
#.#.#C#...#...#
###.###########
#.............#
#.###.###.#####
#.#.#.#.#.#..E#
#.#.#.#.###.#.#
#.#.........#S#
#.#.#.#####.###
#.#.#...#G....#
###############
