13 13 2
#############
#.....#.#..E#
#####.#.#.###
#C....#.#.#.#
#####.#.#.#.#
#.....#C....#
###.#.#.#####
#...#.....#.#
#########.#.#
#.#G........#
#.###.#.#.###
#....E#....S#
#############
