13 17 2
#############
#........C#.#
#.#####.###.#
#...#...#...#
###.#####.#.#
#C.......E#.#
#.###.###.###
#...#...#...#
#.###########
#.....#..S#E#
#.###.#.#.#.#
#...#...#...#
#.#.#.#####.#
#.#...#.....#
#.#.#.#.#.#.#
#.#.#.#G#.#.#
#############
