15 19 2
###############
#..G#.#..C#.#.#
#.###.#.###.#.#
#.....#...#...#
#####.#.###.#.#
#...#.#.......#
#.#.#.#.###.#.#
#.#.....#...#.#
#.###.#####.###
#.#...#.#.#...#
###.###.#.#.#.#
#...#.#E....#.#
###.#.###.###.#
#...#.#.#...#.#
#####.#.#.#.###
#.#....S.E#...#
#.#.#.#.###.#.#
#...#.#...#.#C#
###############
