17 19 2
#################
#...#.#.#.#....C#
#.###.#.#.#.#####
#...#.....#...#.#
#.#.#.###.#.#.#.#
#.#.....#.#.#...#
#######.###.###.#
#..E....#.....#.#
#.#.###.###.#.###
#.#.#.#..S.C#...#
###.#.#########.#
#.#.........#...#
#.#.#.#####.#####
#...#.#.#G......#
#.###.#.#####.###
#...#.....#....E#
#.#.###.#.###.#.#
#.#.#...#.#.....#
#################
