13 15 2
#############
#E......#..C#
###.###.#.#.#
#.....#...#.#
#####.#####.#
#...#..E#.#S#
###.###.#.#.#
#.#.#.#..G#.#
#.#.#.#.#.###
#...#.#...#.#
#.###.#.#.#.#
#.....#.#...#
#.###.###.###
#.#....C....#
#############
