15 17 2
###############
#.#...#.....#.#
#.###.#.#.###.#
#...#.#.#.#.#.#
#.#.#.#.###.#.#
#E#.#.#.#..S#C#
#.###.#.#.###.#
#........G....#
###.#.###.#.#.#
#...#.#.#.#E#.#
#.#####.#.#.###
#.......#.#...#
#####.#########
#C..........#.#
###.#.###.#.#.#
#...#...#.....#
###############
