15 15 2
###############
#..C#....E#C..#
#.#######.###.#
#.....#.#...#.#
#.###.#.###.#.#
#...#.#.......#
###.#.###.#.#.#
#.#.#.#..G#.#.#
#.#.#.###.#####
#.....#......E#
#.###.###.###.#
#...#.....#...#
#.#####.#.#####
#.#....S#.....#
###############
