17 15 2
#################
#E#....C#..G#..C#
#.#.###.###.###.#
#...#.......#...#
#####.###.#.#.###
#.......#.#E....#
#.#######.###.#.#
#.#.#.....#...#.#
#.#.#########.###
#...#.#.........#
#.#.#.#.#.###.#.#
#.#...#.#S..#.#.#
#.#.#####.###.#.#
#.....#.....#.#.#
#################
