15 17 2
###############
#...#.#.#...#.#
#.###.#.#.#.#.#
#...#.#.#.#...#
###.#.#.#.#####
#..C.........E#
#.#.###.#.#####
#.#E..#.#..S..#
#.#######.#####
#.#.....#...#.#
#.#.#########.#
#.....#.......#
###.###.#.#.###
#...#..G#...#.#
#.#.#.#.#.###.#
#.#..C#.#.....#
###############
