19 15 2
###################
#..E........#....E#
#.#####.#.#####.###
#.....#.#.........#
###.#.#.#.#.#######
#...#.#.#.#S..#...#
###.#.#.#########.#
#...#.#C#.#C..#...#
#.#####.#.#.#.###.#
#...#.#.....#.....#
###.#.#.#.#.###.#.#
#..G....#.#...#.#.#
#.#######.###.#.#.#
#.#.......#...#.#.#
###################
