19 19 2
###################
#...#C#...#.....#.#
#.#.#.#.#.#####.#.#
#.......#...#.#...#
###.#.#######.#.###
#.#.#...#E......#.#
#.###.#######.#.#.#
#.......#...#.#.#G#
###.#.#####.#.###.#
#.#.#.#...........#
#.###.#.#.###.###.#
#S#.....#.#..E#...#
#.###.#######.###.#
#.........#.#.#.#.#
###.#######.###.#.#
#.#.....#.#.......#
#.#.#####.#.#####.#
#.....#.......#C..#
###################
