13 13 2
#############
#.......#...#
#.#.#.#####.#
#S#.#...#.#.#
#.###.#.#.#.#
#...#C#E#C.E#
#####.#.#.###
#.....#.....#
#.###.#.###.#
#.#.......#.#
#.#.###.#####
#G#...#.....#
#############
