15 19 2
###############
#E....#..C#...#
###.#####.#.###
#.....#.#.....#
#.###.#.#.#.###
#.#.....#...#.#
###.#######.#.#
#.......#.....#
###.#.#######.#
#...#.#..E#.#.#
#####.#.###.#.#
#.#.........#.#
#.#.#.###.###.#
#G..#.#S......#
###.#.#.#####.#
#...#C#.#.....#
#.#.#.###.###.#
#.#.#...#...#.#
###############
