15 13 2
###############
#.#.#E..#.#E..#
#.#.###.#.#.###
#......C......#
#####.###.###.#
#...#.#G..#S.C#
#.#######.#####
#.............#
#.#.#####.#.#.#
#...#.....#.#.#
#.#.###.#####.#
#.#...#.....#.#
###############
