19 19 0
###################
#S................#
#.#####.#########.#
#...#...#...#...#.#
#.#.#.#.#.#.#.#.#.#
#.#.#.#.#.#.#.#.#.#
#.#.#.#.#.#.#.#.#.#
#.#...#...#...#...#
#################.#
#.................#
#.###.#####.#####.#
#.#.....#...#.....#
#.#.###.#.#.#####.#
#.#...#.#.#.#.....#
#.###.#.#.#.#.###.#
#.....#...#...#...#
#.#################
#...............#G#
###################
