 ↑   ←   ↓   ↓   ←   ←   ↑   →   →   ↓   →   ↓   ↓   ↓   →   ↑   ↑   ↓   ↓   ←   →   ↑   →   ↑   ←   ←   ←   ↓   ↓   ↑   →   ←   →   ↑   ↑   ←   ↑   ←   →   ↓   ←   ↑   ←   ↓   ↑   ↓   →   →   →
 ↓   ↑   ↓   ↓   ←   ↓   →   ↑   ↑   →   →   ↓   →   ↓   ↑   ↑   →   ←   ↓   ↓   →   ↑   →   ←   ↓   →   ↑   ↓   ←   ↓   ↓   ←   ↓   ←   ↑   ↑   ↓   ↓   ↑   ↓   →   ↑   ↑   →   →   ↓   ↑   ↓   ↓
 ↑   ↑   →   ↓   ←   ↓   ←   ←   ↑   ↓   ↑   ←   ←   →   →   ←   →   ←   ←   ←   ←   ←   →   ↓   ←   ↓   →   ↓   ←   ↑   ↓   ↓   →   ↓   ↑   ↓   →   ↑   ↑   ←   ←   ←   →   →   ↑   ↓   ↓   →   ←
 →   ←   →   ↓   ↓   ←   →   ↑   ←   ↑   →   ↑   ↑   ↑   →   ←   ↓   ↑   ←   ←   ↑   →   ←   ↓   ↑   →   ↑   ↓   →   ↑   ↑   ↑   ↑   →   ←   ←   ↑   ↓   ↓   →   ←   →   →   →   ↓   ↓   ←   →   ↑
 ↑   ↑   →   ←   →   →   ↑   ↓   ↑   ←   ↑   ↓   ↓   ↓   ←   ↑   →   ↑   →   ↑   →   ↓   ←   ←   ←   ↑   ←   ←   ↑   →   ↓   ←   ↓   ↑   ↑   ↑   ←   →   ↓   ↓   →   ↓   →   ↑   →   ↑   ←   ↑   ↓
 ↓   ↓   ↑   →   →   ←   ←   ←   ←   →   ←   ↑   ↓   ←   ↓   ←   →   ↓   ↓   →   →   ←   ←   ↑   ↑   →   →   ↑   ←   ↓   ←   →   →   →   →   ←   ←   ←   ↑   ←   ↑   ↑   →   ↑   ←   ↓   ←   ↑   →
 ↑   ←   ↑   ←   →   →   ↑   ↑   ↓   ↑   ↓   ←   →   ↓   ←   →   ↑   ←   →   ↓   ←   ↓   ↓   →   ←   ↑   ↑   ↑   ←   ↑   ↑   ↓   ←   ←   ↓   ←   ↑   ↑   ↓   ←   →   ↓   ←   ←   →   →   ←   ↓   ←
 ↓   ↓   ↑   ←   ↑   ←   ↓   →   ↑   ↑   ↑   →   ↓   ←   →   ↑   ←   ←   ↓   ↓   ←   ↓   ↓   ↓   →   ↓   ↓   ←   ↑   ←   →   ↑   →   →   ↓   ↓   →   ←   ↓   ←   →   ↓   ↑   ←   ←   ↑   ↑   ↑   ←
 ↑   ↓   ↑   ←   ↓   ←   ←   ↓   ↑   ↓   ↑   ↑   →   ←   →   ↑   ←   ↑   →   ↓   ↓   ↑   ←   ↑   ↓   ↓   →   ↓   ↑   ←   →   →   ↑   ↑   ↑   →   ←   →   ←   ↑   ↓   ←   ←   ↓   ↑   ↑   ←   →   ←
 ↑   ←   ↓   ↓   ←   ←   ↑   →   →   ↓   →   ↓   ↓   ↓   →   ↑   ↑   ↓   ↓   ←   →   ↑   →   ↑   ←   ←   ←   ↓   ↓   ↑   →   ←   →   ↑   ↑   ←   ↑   ←   →   ↓   ←   ↑   ←   ↓   ↑   ↓   →   →   →
 ↓   ↑   ↓   ↓   ←   ↓   →   ↑   ↑   →   →   ↓   →   ↓   ↑   ↑   →   ←   ↓   ↓   →   ↑   →   ←   ↓   →   ↑   ↓   ←   ↓   ↓   ←   ↓   ←   ↑   ↑   ↓   ↓   ↑   ↓   →   ↑   ↑   →   →   ↓   ↑   ↓   ↓
 ↑   ↑   →   ↓   ←   ↓   ←   ←   ↑   ↓   ↑   ←   ←   →   →   ←   →   ←   ←   ←   ←   ←   →   ↓   ←   ↓   →   ↓   ←   ↑   ↓   ↓   →   ↓   ↑   ↓   →   ↑   ↑   ←   ←   ←   →   →   ↑   ↓   ↓   →   ←
 →   ←   →   ↓   ↓   ←   →   ↑   ←   ↑   →   ↑   ↑   ↑   →   ←   ↓   ↑   ←   ←   ↑   →   ←   ↓   ↑   →   ↑   ↓   →   ↑   ↑   ↑   ↑   →   ←   ←   ↑   ↓   ↓   →   ←   →   →   →   ↓   ↓   ←   →   ↑
 ↑   ↑   →   ←   →   →   ↑   ↓   ↑   ←   ↑   ↓   ↓   ↓   ←   ↑   →   ↑   →   ↑   →   ↓   ←   ←   ←   ↑   ←   ←   ↑   →   ↓   ←   ↓   ↑   ↑   ↑   ←   →   ↓   ↓   →   ↓   →   ↑   →   ↑   ←   ↑   ↓
 ↓   ↓   ↑   →   →   ←   ←   ←   ←   →   ←   ↑   ↓   ←   ↓   ←   →   ↓   ↓   →   →   ←   ←   ↑   ↑   →   →   ↑   ←   ↓   ←   →   →   →   →   ←   ←   ←   ↑   ←   ↑   ↑   →   ↑   ←   ↓   ←   ↑   →
 ↑   ←   ↑   ←   →   →   ↑   ↑   ↓   ↑   ↓   ←   →   ↓   ←   →   ↑   ←   →   ↓   ←   ↓   ↓   →   ←   ↑   ↑   ↑   ←   ↑   ↑   ↓   ←   ←   ↓   ←   ↑   ↑   ↓   ←   →   ↓   ←   ←   →   →   ←   ↓   ←
 ↓   ↓   ↑   ←   ↑   ←   ↓   →   ↑   ↑   ↑   →   ↓   ←   →   ↑   ←   ←   ↓   ↓   ←   ↓   ↓   ↓   →   ↓   ↓   ←   ↑   ←   →   ↑   →   →   ↓   ↓   →   ←   ↓   ←   →   ↓   ↑   ←   ←   ↑   ↑   ↑   ←
 ↑   ↓   ↑   ←   ↓   ←   ←   ↓   ↑   ↓   ↑   ↑   →   ←   →   ↑   ←   ↑   →   ↓   ↓   ↑   ←   ↑   ↓   ↓   →   ↓   ↑   ←   →   →   ↑   ↑   ↑   →   ←   →   ←   ↑   ↓   ←   ←   ↓   ↑   ↑   ←   →   ←
 ↑   ←   ↓   ↓   ←   ←   ↑   →   →   ↓   →   ↓   ↓   ↓   →   ↑   ↑   ↓   ↓   ←   →   ↑   →   ↑   ←   ←   ←   ↓   ↓   ↑   →   ←   →   ↑   ↑   ←   ↑   ←   →   ↓   ←   ↑   ←   ↓   ↑   ↓   →   →   →
 ↓   ↑   ↓   ↓   ←   ↓   →   ↑   ↑   →   →   ↓   →   ↓   ↑   ↑   →   ←   ↓   ↓   →   ↑   →   ←   ↓   →   ↑   ↓   ←   ↓   ↓   ←   ↓   ←   ↑   ↑   ↓   ↓   ↑   ↓   →   ↑   ↑   →   →   ↓   ↑   ↓   ↓
 ↑   ↑   →   ↓   ←   ↓   ←   ←   ↑   ↓   ↑   ←   ←   →   →   ←   →   ←   ←   ←   ←   ←   →   ↓   ←   ↓   →   ↓   ←   ↑   ↓   ↓   →   ↓   ↑   ↓   →   ↑   ↑   ←   ←   ←   →   →   ↑   ↓   ↓   →   ←
 →   ←   →   ↓   ↓   ←   →   ↑   ←   ↑   →   ↑   ↑   ↑   →   ←   ↓   ↑   ←   ←   ↑   →   ←   ↓   ↑   →   ↑   ↓   →   ↑   ↑   ↑   ↑   →   ←   ←   ↑   ↓   ↓   →   ←   →   →   →   ↓   ↓   ←   →   ↑
 ↑   ↑   →   ←   →   →   ↑   ↓   ↑   ←   ↑   ↓   ↓   ↓   ←   ↑   →   ↑   →   ↑   →   ↓   ←   ←   ←   ↑   ←   ←   ↑   →   ↓   ←   ↓   ↑   ↑   ↑   ←   →   ↓   ↓   →   ↓   →   ↑   →   ↑   ←   ↑   ↓
 ↓   ↓   ↑   →   →   ←   ←   ←   ←   →   ←   ↑   ↓   ←   ↓   ←   →   ↓   ↓   →   →   ←   ←   ↑   ↑   →   →   ↑   ←   ↓   ←   →   →   →   →   ←   ←   ←   ↑   ←   ↑   ↑   →   ↑   ←   ↓   ←   ↑   →
 ↑   ←   ↑   ←   →   →   ↑   ↑   ↓   ↑   ↓   ←   →   ↓   ←   →   ↑   ←   →   ↓   ←   ↓   ↓   →   ←   ↑   ↑   ↑   ←   ↑   ↑   ↓   ←   ←   ↓   ←   ↑   ↑   ↓   ←   →   ↓   ←   ←   →   →   ←   ↓   ←
 ↓   ↓   ↑   ←   ↑   ←   ↓   →   ↑   ↑   ↑   →   ↓   ←   →   ↑   ←   ←   ↓   ↓   ←   ↓   ↓   ↓   →   ↓   ↓   ←   ↑   ←   →   ↑   →   →   ↓   ↓   →   ←   ↓   ←   →   ↓   ↑   ←   ←   ↑   ↑   ↑   ←
 ↑   ↓   ↑   ←   ↓   ←   ←   ↓   ↑   ↓   ↑   ↑   →   ←   →   ↑   ←   ↑   →   ↓   ↓   ↑   ←   ↑   ↓   ↓   →   ↓   ↑   ←   →   →   ↑   ↑   ↑   →   ←   →   ←   ↑   ↓   ←   ←   ↓   ↑   ↑   ←   →   ←
 ↑   ←   ↓   ↓   ←   ←   ↑   →   →   ↓   →   ↓   ↓   ↓   →   ↑   ↑   ↓   ↓   ←   →   ↑   →   ↑   ←   ←   ←   ↓   ↓   ↑   →   ←   →   ↑   ↑   ←   ↑   ←   →   ↓   ←   ↑   ←   ↓   ↑   ↓   →   →   →
 ↓   ↑   ↓   ↓   ←   ↓   →   ↑   ↑   →   →   ↓   →   ↓   ↑   ↑   →   ←   ↓   ↓   →   ↑   →   ←   ↓   →   ↑   ↓   ←   ↓   ↓   ←   ↓   ←   ↑   ↑   ↓   ↓   ↑   ↓   →   ↑   ↑   →   →   ↓   ↑   ↓   ↓
 ↑   ↑   →   ↓   ←   ↓   ←   ←   ↑   ↓   ↑   ←   ←   →   →   ←   →   ←   ←   ←   ←   ←   →   ↓   ←   ↓   →   ↓   ←   ↑   ↓   ↓   →   ↓   ↑   ↓   →   ↑   ↑   ←   ←   ←   →   →   ↑   ↓   ↓   →   ←
 →   ←   →   ↓   ↓   ←   →   ↑   ←   ↑   →   ↑   ↑   ↑   →   ←   ↓   ↑   ←   ←   ↑   →   ←   ↓   ↑   →   ↑   ↓   →   ↑   ↑   ↑   ↑   →   ←   ←   ↑   ↓   ↓   →   ←   →   →   →   ↓   ↓   ←   →   ↑
 ↑   ↑   →   ←   →   →   ↑   ↓   ↑   ←   ↑   ↓   ↓   ↓   ←   ↑   →   ↑   →   ↑   →   ↓   ←   ←   ←   ↑   ←   ←   ↑   →   ↓   ←   ↓   ↑   ↑   ↑   ←   →   ↓   ↓   →   ↓   →   ↑   →   ↑   ←   ↑   ↓
 ↓   ↓   ↑   →   →   ←   ←   ←   ←   →   ←   ↑   ↓   ←   ↓   ←   →   ↓   ↓   →   →   ←   ←   ↑   ↑   →   →   ↑   ←   ↓   ←   →   →   →   →   ←   ←   ←   ↑   ←   ↑   ↑   →   ↑   ←   ↓   ←   ↑   →
 ↑   ←   ↑   ←   →   →   ↑   ↑   ↓   ↑   ↓   ←   →   ↓   ←   →   ↑   ←   →   ↓   ←   ↓   ↓   →   ←   ↑   ↑   ↑   ←   ↑   ↑   ↓   ←   ←   ↓   ←   ↑   ↑   ↓   ←   →   ↓   ←   ←   →   →   ←   ↓   ←
 ↓   ↓   ↑   ←   ↑   ←   ↓   →   ↑   ↑   ↑   →   ↓   ←   →   ↑   ←   ←   ↓   ↓   ←   ↓   ↓   ↓   →   ↓   ↓   ←   ↑   ←   →   ↑   →   →   ↓   ↓   →   ←   ↓   ←   →   ↓   ↑   ←   ←   ↑   ↑   ↑   ←
 ↑   ↓   ↑   ←   ↓   ←   ←   ↓   ↑   ↓   ↑   ↑   →   ←   →   ↑   ←   ↑   →   ↓   ↓   ↑   ←   ↑   ↓   ↓   →   ↓   ↑   ←   →   →   ↑   ↑   ↑   →   ←   →   ←   ↑   ↓   ←   ←   ↓   ↑   ↑   ←   →   ←